gene_id,troph,ring,schiz,total,troph_pct,ring_pct,schiz_pct
PVP01_1146900,86,44,6,136,0.6323529411764706,0.3235294117647059,0.04411764705882353
PVP01_1146700,1640,204,39,1883,0.8709506107275624,0.10833775889537971,0.020711630377057887
PVP01_1146600,107,2,0,109,0.981651376146789,0.01834862385321101,0
PVP01_1146400,222,19,7,248,0.8951612903225806,0.07661290322580645,0.028225806451612902
PVP01_1146300,2272,295,401,2968,0.7654986522911051,0.09939353099730458,0.1351078167115903
PVP01_1146200,733,165,26,924,0.7932900432900433,0.17857142857142858,0.02813852813852814
PVP01_1146100,1070,240,41,1351,0.7920059215396003,0.17764618800888232,0.030347890451517395
PVP01_1146000,1785,203,132,2120,0.84198113207547165,0.09575471698113208,0.062264150943396226
PVP01_1145700,837,40,22,899,0.9310344827586207,0.04449388209121246,0.024471635150166853
PVP01_1145600,199,70,36,305,0.6524590163934426,0.22950819672131148,0.1180327868852459
PVP01_1145500,1784,1258,67,3109,0.5738179478932133,0.40463171437761336,0.021550337729173367
PVP01_1145400,9,0,0,9,1,0,0
PVP01_1145200,325,50,176,551,0.5898366606170599,0.09074410163339383,0.3194192377495463
PVP01_1145100,1139,19,114,1272,0.8954402515723271,0.014937106918238994,0.08962264150943396
PVP01_1145000,61,3,4,68,0.8970588235294118,0.04411764705882353,0.058823529411764705
PVP01_1144700,466,25,19,510,0.9137254901960784,0.049019607843137254,0.03725490196078431
PVP01_1144600,2008,186,83,2277,0.8818620992534036,0.08168642951251646,0.03645147123407993
PVP01_1144500,40,8,2,50,0.8,0.16,0.04
PVP01_1144200,166,2,9,177,0.9378531073446328,0.011299435028248588,0.05084745762711865
PVP01_1144100,300,20,107,427,0.702576112412178,0.0468384074941452,0.2505854800936768
PVP01_1144000,206,7,3,216,0.9537037037037037,0.032407407407407406,0.013888888888888888
PVP01_1143700,331,14,14,359,0.9220055710306406,0.03899721448467967,0.03899721448467967
PVP01_1143500,5,1,0,6,0.8333333333333334,0.16666666666666666,0
PVP01_1143400,869,19,37,925,0.9394594594594594,0.02054054054054054,0.04
PVP01_1143300,691,32,129,852,0.8110328638497653,0.03755868544600939,0.15140845070422534
PVP01_1143200,34,1,9,44,0.7727272727272727,0.022727272727272728,0.20454545454545456
PVP01_1143100,1997,88,667,2752,0.7256540697674418,0.03197674418604651,0.24236918604651161
PVP01_1143000,1491,18,71,1580,0.9436708860759494,0.01139240506329114,0.04493670886075949
PVP01_1142800,2781,564,303,3648,0.7623355263157895,0.15460526315789475,0.08305921052631579
PVP01_1142700,288,26,74,388,0.7422680412371134,0.06701030927835051,0.19072164948453607
PVP01_1142500,17,7,2,26,0.6538461538461539,0.2692307692307692,0.07692307692307693
PVP01_1142400,1833,775,173,2781,0.6591154261057174,0.2786767349874146,0.062207838906868033
PVP01_1142200,241,18,15,274,0.8795620437956204,0.06569343065693431,0.05474452554744526
PVP01_1142100,2100,425,39,2564,0.8190327613104524,0.16575663026521062,0.015210608424336974
PVP01_1142000,1198,758,42,1998,0.5995995995995996,0.3793793793793794,0.021021021021021023
PVP01_1141900,83,1,24,108,0.7685185185185185,0.009259259259259259,0.2222222222222222
PVP01_1141800,1191,19,64,1274,0.934850863422292,0.014913657770800628,0.05023547880690738
PVP01_1141700,1089,27,59,1175,0.9268085106382978,0.02297872340425532,0.05021276595744681
PVP01_1141600,496,30,198,724,0.6850828729281768,0.04143646408839779,0.27348066298342544
PVP01_1141500,1254,116,109,1479,0.847870182555781,0.0784313725490196,0.07369844489519946
PVP01_1141400,184,4,20,208,0.8846153846153846,0.019230769230769232,0.09615384615384616
PVP01_1141300,642,25,293,960,0.66875,0.026041666666666668,0.30520833333333336
PVP01_1141200,1461,106,54,1621,0.9012954966070327,0.06539173349784085,0.033312769895126465
PVP01_1141100,4364,520,154,5038,0.8662167526796348,0.10321556173084558,0.03056768558951965
PVP01_1141000,728,22,16,766,0.9503916449086162,0.028720626631853787,0.020887728459530026
PVP01_1140900,1362,83,61,1506,0.9043824701195219,0.0551128818061089,0.04050464807436919
PVP01_1140800,228,27,11,266,0.8571428571428571,0.10150375939849623,0.041353383458646614
PVP01_1140700,3749,383,215,4347,0.8624338624338624,0.08810674028065332,0.04945939728548424
PVP01_1140600,508,91,5,604,0.8410596026490066,0.15066225165562913,0.008278145695364239
PVP01_1140500,103,1,9,113,0.911504424778761,0.008849557522123894,0.07964601769911504
PVP01_1140400,1369,77,23,1469,0.9319264805990469,0.05241660993873383,0.015656909462219197
PVP01_1140200,6116,521,146,6783,0.9016659295297066,0.07680967123691582,0.02152439923337756
PVP01_1140100,1539,151,209,1899,0.8104265402843602,0.0795155344918378,0.110057925223802
PVP01_1139800,11,20,1,32,0.34375,0.625,0.03125
PVP01_1139700,73,15,8,96,0.7604166666666666,0.15625,0.08333333333333333
PVP01_1139500,570,114,101,785,0.7261146496815286,0.14522292993630573,0.1286624203821656
PVP01_1139400,74,2,12,88,0.8409090909090909,0.022727272727272728,0.13636363636363635
PVP01_1139300,1528,567,307,2402,0.6361365528726062,0.23605328892589508,0.12781015820149874
PVP01_1139000,195,35,8,238,0.819327731092437,0.14705882352941177,0.03361344537815126
PVP01_1138900,3969,547,248,4764,0.8331234256926953,0.11481947942905121,0.052057094878253565
PVP01_1138600,357,43,7,407,0.8771498771498771,0.10565110565110565,0.0171990171990172
PVP01_1138500,185,22,9,216,0.8564814814814815,0.10185185185185185,0.041666666666666664
PVP01_1138400,3786,337,112,4235,0.8939787485242031,0.0795749704840614,0.026446280991735537
PVP01_1138200,53,3,12,68,0.7794117647058824,0.04411764705882353,0.17647058823529413
PVP01_1138100,562,22,15,599,0.9382303839732888,0.03672787979966611,0.025041736227045076
PVP01_1138000,2988,196,59,3243,0.9213691026827012,0.06043786617329633,0.018193031144002468
PVP01_1137900,698,20,10,728,0.9587912087912088,0.027472527472527472,0.013736263736263736
PVP01_1137800,656,172,31,859,0.7636786961583236,0.20023282887077998,0.03608847497089639
PVP01_1137700,6,0,3,9,0.6666666666666666,0,0.3333333333333333
PVP01_1137500,1345,668,72,2085,0.645083932853717,0.3203836930455635,0.034532374100719423
PVP01_1137200,554,58,26,638,0.8683385579937304,0.09090909090909091,0.04075235109717868
PVP01_1137100,69,2,16,87,0.7931034482758621,0.022988505747126436,0.1839080459770115
PVP01_1137000,234,198,55,487,0.4804928131416838,0.406570841889117,0.11293634496919917
PVP01_1136800,154,6,131,291,0.5292096219931272,0.020618556701030927,0.45017182130584193
PVP01_1136700,334,7,196,537,0.6219739292364991,0.01303538175046555,0.3649906890130354
PVP01_1136600,8,3,3,14,0.5714285714285714,0.21428571428571427,0.21428571428571427
PVP01_1136500,703,329,50,1082,0.6497227356746765,0.30406654343807765,0.04621072088724584
PVP01_1136300,572,259,764,1595,0.3586206896551724,0.16238244514106584,0.4789968652037618
PVP01_1136200,1117,1477,163,2757,0.4051505259339862,0.5357272397533551,0.059122234312658686
PVP01_1136100,353,16,13,382,0.9240837696335078,0.041884816753926704,0.034031413612565446
PVP01_1136000,28,9,9,46,0.6086956521739131,0.1956521739130435,0.1956521739130435
PVP01_1135900,35,1,1,37,0.9459459459459459,0.02702702702702703,0.02702702702702703
PVP01_1135800,116,3,1365,1484,0.07816711590296496,0.0020215633423180594,0.9198113207547169
PVP01_1135700,1862,35,95,1992,0.9347389558232931,0.017570281124497992,0.04769076305220884
PVP01_1135600,1147,210,242,1599,0.7173233270794246,0.13133208255159476,0.15134459036898062
PVP01_1135400,1346,130,111,1587,0.8481411468178954,0.08191556395715185,0.06994328922495274
PVP01_1135200,54,22,1620,1696,0.031839622641509434,0.012971698113207548,0.9551886792452831
PVP01_1135000,1315,56,2023,3394,0.3874484384207425,0.016499705362404242,0.5960518562168533
PVP01_1134900,852,244,352,1448,0.5883977900552486,0.1685082872928177,0.2430939226519337
PVP01_1134800,442,383,134,959,0.4608967674661105,0.3993743482794578,0.1397288842544317
PVP01_0203100,5,1,0,6,0.8333333333333334,0.16666666666666666,0
PVP01_0203200,930,71,18,1019,0.9126594700686947,0.06967615309126594,0.017664376840039256
PVP01_0203300,345,8,13,366,0.9426229508196722,0.02185792349726776,0.03551912568306011
PVP01_0203400,2523,394,80,2997,0.8418418418418419,0.1314647981314648,0.02669336002669336
PVP01_0203500,246,33,9,288,0.8541666666666666,0.11458333333333333,0.03125
PVP01_0203600,1153,122,36,1311,0.8794813119755912,0.09305873379099924,0.02745995423340961
PVP01_0203700,1331,361,47,1739,0.765382403680276,0.20759056929269695,0.02702702702702703
PVP01_0203900,1035,217,36,1288,0.8035714285714286,0.16847826086956522,0.027950310559006212
PVP01_0204000,157,10,4,171,0.9181286549707602,0.05847953216374269,0.023391812865497075
PVP01_0204200,375,41,8,424,0.8844339622641509,0.09669811320754718,0.018867924528301886
PVP01_0204300,662,260,97,1019,0.6496565260058881,0.25515210991167814,0.09519136408243375
PVP01_0204500,2776,563,1148,4487,0.6186761756184533,0.1254735903721863,0.25585023400936036
PVP01_0204700,1080,448,41,1569,0.6883365200764818,0.2855321861057999,0.026131293817718292
PVP01_0204800,618,39,78,735,0.8408163265306122,0.053061224489795916,0.10612244897959183
PVP01_0204900,3218,188,556,3962,0.812216052498738,0.04745078243311459,0.14033316506814741
PVP01_0205000,12,2,2,16,0.75,0.125,0.125
PVP01_0205100,40,1,6,47,0.851063829787234,0.02127659574468085,0.1276595744680851
PVP01_0205200,279,8,221,508,0.5492125984251969,0.015748031496062992,0.43503937007874016
PVP01_0205300,1921,928,373,3222,0.5962135319677219,0.2880198634388578,0.11576660459342024
PVP01_0205400,1296,721,505,2522,0.5138778747026169,0.2858842188739096,0.20023790642347344
PVP01_0205500,353,42,2,397,0.889168765743073,0.10579345088161209,0.005037783375314861
PVP01_0205600,116,41,5,162,0.7160493827160493,0.25308641975308643,0.030864197530864196
PVP01_0205700,813,22,19,854,0.9519906323185011,0.02576112412177986,0.02224824355971897
PVP01_0205900,517,68,15,600,0.8616666666666667,0.11333333333333333,0.025
PVP01_0206100,3,1,78,82,0.036585365853658534,0.012195121951219513,0.9512195121951219
PVP01_0206200,352,58,11,421,0.836104513064133,0.1377672209026128,0.026128266033254157
PVP01_0206400,1463,38,122,1623,0.9014171287738756,0.02341343191620456,0.0751694393099199
PVP01_0206600,964,1305,52,2321,0.4153382162860836,0.5622576475657044,0.02240413614821198
PVP01_0206800,633,58,20,711,0.890295358649789,0.08157524613220815,0.028129395218002812
PVP01_0206900,1030,62,27,1119,0.9204647006255585,0.05540661304736372,0.024128686327077747
PVP01_0207000,17,4,26,47,0.3617021276595745,0.0851063829787234,0.5531914893617021
PVP01_0207100,625,56,27,708,0.882768361581921,0.07909604519774012,0.038135593220338986
PVP01_0207200,239,11,1,251,0.952191235059761,0.043824701195219126,0.00398406374501992
PVP01_0207500,274,5,39,318,0.8616352201257862,0.015723270440251572,0.12264150943396226
PVP01_0207600,374,16,103,493,0.7586206896551724,0.032454361054766734,0.20892494929006086
PVP01_0207700,1602,65,333,2000,0.801,0.0325,0.1665
PVP01_0207900,702,31,79,812,0.8645320197044335,0.038177339901477834,0.09729064039408868
PVP01_0208000,85,3,21,109,0.7798165137614679,0.027522935779816515,0.1926605504587156
PVP01_0208100,1109,1719,283,3111,0.35647701703632273,0.5525554484088717,0.09096753455480552
PVP01_0208400,10,13,0,23,0.43478260869565216,0.5652173913043478,0
PVP01_0208600,256,7,161,424,0.6037735849056604,0.01650943396226415,0.37971698113207547
PVP01_0208700,1773,388,55,2216,0.8000902527075813,0.17509025270758122,0.024819494584837544
PVP01_0208900,595,27,35,657,0.9056316590563166,0.0410958904109589,0.0532724505327245
PVP01_0209200,666,83,60,809,0.823238566131026,0.10259579728059333,0.07416563658838071
PVP01_0209300,1104,67,23,1194,0.9246231155778895,0.05611390284757119,0.019262981574539362
PVP01_0209500,1014,10,52,1076,0.9423791821561338,0.00929368029739777,0.048327137546468404
PVP01_0209600,1730,258,43,2031,0.8517971442639094,0.12703101920236337,0.02117183653372723
PVP01_0209700,1790,47,155,1992,0.8985943775100401,0.02359437751004016,0.07781124497991967
PVP01_0209900,44,0,0,44,1,0,0
PVP01_0210000,7,0,2,9,0.7777777777777778,0,0.2222222222222222
PVP01_0210200,1242,109,32,1383,0.8980477223427332,0.07881417208966016,0.023138105567606652
PVP01_0210300,571,186,21,778,0.7339331619537275,0.2390745501285347,0.02699228791773779
PVP01_0210500,413,328,7620,8361,0.04939600526252841,0.03922975720607583,0.9113742375313958
PVP01_0210600,132,1,122,255,0.5176470588235295,0.00392156862745098,0.47843137254901963
PVP01_0210700,250,3,48,301,0.8305647840531561,0.009966777408637873,0.15946843853820597
PVP01_0210800,930,90,18,1038,0.8959537572254336,0.08670520231213873,0.017341040462427744
PVP01_0210900,456,5,26,487,0.9363449691991786,0.01026694045174538,0.053388090349075976
PVP01_0211000,3149,211,760,4120,0.7643203883495145,0.05121359223300971,0.18446601941747573
PVP01_0211200,108,20,173,301,0.3588039867109635,0.0664451827242525,0.574750830564784
PVP01_0211300,384,18,18,420,0.9142857142857143,0.04285714285714286,0.04285714285714286
PVP01_0211500,1422,168,33,1623,0.8761552680221811,0.10351201478743069,0.02033271719038817
PVP01_0211600,1546,126,329,2001,0.7726136931534233,0.06296851574212893,0.16441779110444776
PVP01_0211700,416,5,61,482,0.8630705394190872,0.01037344398340249,0.12655601659751037
PVP01_0211800,4050,1731,629,6410,0.6318252730109204,0.27004680187207486,0.09812792511700467
PVP01_0212000,2828,135,231,3194,0.8854101440200376,0.04226675015654352,0.07232310582341892
PVP01_0212200,1289,213,79,1581,0.8153067678684377,0.1347248576850095,0.04996837444655281
PVP01_0212400,1638,85,55,1778,0.9212598425196851,0.047806524184476944,0.03093363329583802
PVP01_0212500,1225,132,36,1393,0.8793969849246231,0.09475951184493898,0.025843503230437905
PVP01_0212600,650,252,20,922,0.7049891540130152,0.27331887201735355,0.021691973969631236
PVP01_0212700,350,24,46,420,0.8333333333333334,0.05714285714285714,0.10952380952380952
PVP01_0212800,353,293,180,826,0.42736077481840196,0.35472154963680386,0.2179176755447942
PVP01_0212900,1920,216,152,2288,0.8391608391608392,0.0944055944055944,0.06643356643356643
PVP01_0213000,748,47,26,821,0.9110840438489647,0.057247259439707675,0.031668696711327646
PVP01_0213100,1587,117,36,1740,0.9120689655172414,0.06724137931034482,0.020689655172413793
PVP01_0213200,1449,96,72,1617,0.8961038961038961,0.059369202226345084,0.04452690166975881
PVP01_0213300,172,34,10,216,0.7962962962962963,0.1574074074074074,0.046296296296296294
PVP01_0213400,283,22,19,324,0.8734567901234568,0.06790123456790123,0.05864197530864197
PVP01_0213500,928,85,52,1065,0.8713615023474178,0.07981220657276995,0.048826291079812206
PVP01_0213700,2948,887,74,3909,0.7541570734203121,0.22691225377334356,0.018930672806344334
PVP01_0213900,376,25,21,422,0.8909952606635071,0.05924170616113744,0.04976303317535545
PVP01_0214000,305,20,9,334,0.9131736526946108,0.059880239520958084,0.02694610778443114
PVP01_0214100,69,5,1,75,0.92,0.06666666666666667,0.013333333333333334
PVP01_0214200,1,0,0,1,1,0,0
PVP01_0214300,362,29,27,418,0.8660287081339713,0.06937799043062201,0.0645933014354067
PVP01_0214400,341,18,1331,1690,0.2017751479289941,0.010650887573964497,0.7875739644970414
PVP01_0214500,2415,84,424,2923,0.8262059527882313,0.028737598357851522,0.14505644885391722
PVP01_0214600,1437,227,32,1696,0.8472877358490566,0.1338443396226415,0.018867924528301886
PVP01_0214700,112,39,2,153,0.7320261437908496,0.2549019607843137,0.013071895424836602
PVP01_0214900,121,36,5,162,0.7469135802469136,0.2222222222222222,0.030864197530864196
PVP01_0215000,800,951,42,1793,0.44617958728388174,0.5303959843837145,0.023424428332403793
PVP01_0215100,1100,2054,58,3212,0.3424657534246575,0.6394769613947696,0.01805728518057285
PVP01_0215200,1250,232,648,2130,0.5868544600938967,0.10892018779342723,0.30422535211267604
PVP01_0215300,1056,99,43,1198,0.8814691151919867,0.08263772954924875,0.03589315525876461
PVP01_0215400,144,3,598,745,0.19328859060402684,0.004026845637583893,0.8026845637583893
PVP01_0215500,3,0,1,4,0.75,0,0.25
PVP01_0215700,23,4,1,28,0.8214285714285714,0.14285714285714285,0.03571428571428571
PVP01_0215800,1556,253,39,1848,0.841991341991342,0.13690476190476192,0.021103896103896104
PVP01_0215900,354,50,24,428,0.8271028037383178,0.11682242990654206,0.056074766355140186
PVP01_0216100,63,1,78,142,0.44366197183098594,0.007042253521126761,0.5492957746478874
PVP01_0422400,343,4,48,395,0.8683544303797468,0.010126582278481013,0.12151898734177215
PVP01_0422300,940,38,15,993,0.94662638469285,0.038267875125881166,0.015105740181268883
PVP01_0421800,64,2,11,77,0.8311688311688312,0.025974025974025976,0.14285714285714285
PVP01_0421700,684,19,26,729,0.9382716049382716,0.026063100137174212,0.03566529492455418
PVP01_0421500,511,20,9,540,0.9462962962962963,0.037037037037037035,0.016666666666666666
PVP01_0421400,321,462,24,807,0.39776951672862454,0.5724907063197026,0.02973977695167286
PVP01_0421300,90,1,8,99,0.9090909090909091,0.010101010101010102,0.08080808080808081
PVP01_0421000,482,144,151,777,0.6203346203346203,0.18532818532818532,0.19433719433719435
PVP01_0420900,695,232,202,1129,0.6155890168290522,0.20549158547387067,0.17891939769707707
PVP01_0420800,223,37,23,283,0.7879858657243817,0.13074204946996468,0.0812720848056537
PVP01_0420700,5,1,0,6,0.8333333333333334,0.16666666666666666,0
PVP01_0420600,810,459,48,1317,0.6150341685649203,0.34851936218678814,0.03644646924829157
PVP01_0420500,1684,161,362,2207,0.763026733121885,0.0729497054825555,0.16402356139555957
PVP01_0420400,105,12,9,126,0.8333333333333334,0.09523809523809523,0.07142857142857142
PVP01_0420300,182,19,7,208,0.875,0.09134615384615384,0.03365384615384615
PVP01_0420200,509,32,15,556,0.9154676258992805,0.05755395683453238,0.02697841726618705
PVP01_0419900,1,0,0,1,1,0,0
PVP01_0419700,1353,150,35,1538,0.8797139141742523,0.09752925877763328,0.022756827048114433
PVP01_0419500,1009,52,138,1199,0.841534612176814,0.043369474562135114,0.11509591326105087
PVP01_0419400,2219,119,98,2436,0.9109195402298851,0.04885057471264368,0.040229885057471264
PVP01_0419300,566,4,49,619,0.9143780290791599,0.006462035541195477,0.0791599353796446
PVP01_0419200,2007,201,91,2299,0.8729882557633754,0.08742931709438886,0.039582427142235754
PVP01_0419100,3652,252,230,4134,0.8834059022738268,0.06095791001451379,0.05563618771165941
PVP01_0419000,880,40,227,1147,0.7672188317349607,0.03487358326068003,0.1979075850043592
PVP01_0418900,15,1,12,28,0.5357142857142857,0.03571428571428571,0.42857142857142855
PVP01_0418600,80,49,2,131,0.6106870229007634,0.37404580152671757,0.015267175572519083
PVP01_0418500,93,112,5,210,0.44285714285714284,0.5333333333333333,0.023809523809523808
PVP01_0418200,1066,146,4499,5711,0.18665732796357906,0.02556469970232884,0.7877779723340921
PVP01_0418100,233,32,10,275,0.8472727272727273,0.11636363636363636,0.03636363636363636
PVP01_0416700,739,23,16,778,0.9498714652956298,0.02956298200514139,0.02056555269922879
PVP01_0416600,414,895,48,1357,0.3050847457627119,0.6595431098010317,0.03537214443625645
PVP01_0416500,808,302,145,1255,0.6438247011952192,0.24063745019920318,0.11553784860557768
PVP01_0416400,554,58,34,646,0.8575851393188855,0.08978328173374613,0.05263157894736842
PVP01_0416300,82,1,3,86,0.9534883720930233,0.011627906976744186,0.03488372093023256
PVP01_0416100,862,114,21,997,0.8645937813440321,0.11434302908726178,0.02106318956870612
PVP01_0416000,726,128,23,877,0.8278221208665907,0.1459521094640821,0.026225769669327253
PVP01_0415800,353,11,40,404,0.8737623762376238,0.027227722772277228,0.09900990099009901
PVP01_0415700,1440,260,192,1892,0.7610993657505285,0.13742071881606766,0.1014799154334038
PVP01_0415600,177,15,5,197,0.8984771573604061,0.07614213197969544,0.025380710659898477
PVP01_0415500,90,22,1,113,0.7964601769911505,0.19469026548672566,0.008849557522123894
PVP01_0415400,345,14,12,371,0.9299191374663073,0.03773584905660377,0.03234501347708895
PVP01_0415200,2051,27,1174,3252,0.6306888068880688,0.008302583025830259,0.36100861008610086
PVP01_0415000,4941,1576,155,6672,0.7405575539568345,0.23621103117505995,0.023231414868105517
PVP01_0414900,50,5,6,61,0.819672131147541,0.08196721311475409,0.09836065573770492
PVP01_0414800,4811,2446,266,7523,0.6395055164163232,0.3251362488369002,0.03535823474677655
PVP01_0414700,1565,70,55,1690,0.9260355029585798,0.04142011834319527,0.03254437869822485
PVP01_0414500,170,1,8,179,0.94972067039106145,0.00558659217877095,0.0446927374301676
PVP01_0414400,1546,441,1046,3033,0.5097263435542367,0.14540059347181009,0.3448730629739532
PVP01_0414100,184,12,20,216,0.8518518518518519,0.05555555555555555,0.09259259259259259
PVP01_0414000,495,329,37,861,0.5749128919860628,0.3821138211382114,0.0429732868757259
PVP01_0413900,136,31,3,170,0.8,0.18235294117647058,0.01764705882352941
PVP01_0413800,112,4,10,126,0.8888888888888888,0.031746031746031744,0.07936507936507936
PVP01_0413700,345,18,7,370,0.9324324324324325,0.04864864864864865,0.01891891891891892
PVP01_0413600,64,1,17,82,0.7804878048780488,0.012195121951219513,0.2073170731707317
PVP01_0413500,2396,94,1018,3508,0.6830102622576967,0.026795895096921322,0.290193842645382
PVP01_0413300,142,4,2,148,0.9594594594594594,0.02702702702702703,0.013513513513513514
PVP01_0413200,2080,1541,161,3782,0.5499735589635114,0.40745637228979376,0.04257006874669487
PVP01_0413000,563,15,121,699,0.8054363376251789,0.02145922746781116,0.17310443490701002
PVP01_0412900,427,9,35,471,0.9065817409766455,0.01910828025477707,0.07430997876857749
PVP01_0412600,2730,854,127,3711,0.7356507679870655,0.2301266504985179,0.0342225815144166
PVP01_0412500,522,99,250,871,0.5993111366245695,0.11366245694603903,0.2870264064293915
PVP01_0412300,34,25,1072,1131,0.030061892130857647,0.022104332449160036,0.9478337754199824
PVP01_0412200,915,23,25,963,0.9501557632398754,0.023883696780893044,0.02596053997923157
PVP01_0412100,1142,41,30,1213,0.9414674361088211,0.033800494641384994,0.0247320692497939
PVP01_0412000,1050,111,44,1205,0.8713692946058091,0.09211618257261411,0.036514522821576766
PVP01_0411900,87,5,13,105,0.8285714285714286,0.047619047619047616,0.12380952380952381
PVP01_0411500,577,16,9,602,0.9584717607973422,0.026578073089700997,0.014950166112956811
PVP01_0411400,1039,109,103,1251,0.8305355715427658,0.08713029576338929,0.08233413269384493
PVP01_0411200,451,125,48,624,0.7227564102564102,0.20032051282051283,0.07692307692307693
PVP01_0411100,37,2,13,52,0.7115384615384616,0.038461538461538464,0.25
PVP01_0411000,502,143,74,719,0.6981919332406119,0.19888734353268428,0.10292072322670376
PVP01_0410900,4070,547,407,5024,0.8101114649681529,0.10887738853503184,0.08101114649681529
PVP01_0410800,1326,294,198,1818,0.7293729372937293,0.1617161716171617,0.10891089108910891
PVP01_0410700,785,24,22,831,0.9446450060168472,0.02888086642599278,0.026474127557160047
PVP01_0410500,2169,2989,114,5272,0.4114188163884674,0.5669575113808801,0.021623672230652504
PVP01_0410400,88,87,3,178,0.4943820224719101,0.4887640449438202,0.016853932584269662
PVP01_0410200,29,23,1862,1914,0.015151515151515152,0.012016718913270637,0.9728317659352143
PVP01_0410100,338,187,388,913,0.3702081051478642,0.20481927710843373,0.4249726177437021
PVP01_0409800,903,32,96,1031,0.8758486905916586,0.031037827352085354,0.09311348205625607
PVP01_0409700,114,6,11,131,0.8702290076335878,0.04580152671755725,0.08396946564885496
PVP01_0409600,999,71,655,1725,0.5791304347826087,0.04115942028985507,0.37971014492753624
PVP01_0409200,1394,18,48,1460,0.9547945205479452,0.012328767123287671,0.03287671232876712
PVP01_0409100,76,8,103,187,0.40641711229946526,0.0427807486631016,0.5508021390374331
PVP01_0409000,260,24,27,311,0.8360128617363344,0.07717041800643087,0.08681672025723473
PVP01_0408900,234,42,8,284,0.823943661971831,0.14788732394366197,0.028169014084507043
PVP01_0408800,397,59,16,472,0.8411016949152542,0.125,0.03389830508474576
PVP01_0408700,615,85,25,725,0.8482758620689655,0.11724137931034483,0.034482758620689655
PVP01_0408600,546,54,13,613,0.8907014681892332,0.08809135399673736,0.021207177814029365
PVP01_0408500,480,10,48,538,0.8921933085501859,0.01858736059479554,0.08921933085501858
PVP01_0408400,3282,433,1710,5425,0.6049769585253456,0.07981566820276498,0.3152073732718894
PVP01_0408300,642,433,3560,4635,0.13851132686084142,0.09341963322545847,0.7680690399137001
PVP01_0408200,330,4,216,550,0.6,0.007272727272727273,0.3927272727272727
PVP01_0408100,365,2,155,522,0.6992337164750958,0.0038314176245210726,0.29693486590038315
PVP01_0408000,29,1,1,31,0.9354838709677419,0.03225806451612903,0.03225806451612903
PVP01_0407900,4622,116,94,4832,0.9565397350993378,0.024006622516556293,0.01945364238410596
PVP01_0407700,49,10,28,87,0.5632183908045977,0.11494252873563218,0.3218390804597701
PVP01_0407600,674,91,85,850,0.7929411764705883,0.10705882352941176,0.1
PVP01_0407500,2029,34,3767,5830,0.34802744425385934,0.005831903945111492,0.6461406518010292
PVP01_0407400,935,211,533,1679,0.5568790946992257,0.12567004169148302,0.31745086360929126
PVP01_0407300,121,12,6,139,0.8705035971223022,0.08633093525179857,0.04316546762589928
PVP01_0407200,7528,2365,161,10054,0.7487567137457728,0.23522975929978118,0.01601352695444599
PVP01_0407100,294,45,75,414,0.7101449275362319,0.10869565217391304,0.18115942028985507
PVP01_0407000,938,29,31,998,0.9398797595190381,0.02905811623246493,0.031062124248496994
PVP01_0406900,18,1,17,36,0.5,0.027777777777777776,0.4722222222222222
PVP01_0406700,967,129,25,1121,0.8626226583407671,0.11507582515611062,0.02230151650312221
PVP01_0406600,110,129,29,268,0.41044776119402987,0.48134328358208955,0.10820895522388059
PVP01_0406500,1639,400,64,2103,0.7793628150261531,0.1902044698050404,0.030432715168806468
PVP01_0406300,1565,1167,306,3038,0.5151415404871627,0.38413429888084266,0.10072416063199473
PVP01_0405800,5293,2600,474,8367,0.6326042787139955,0.31074459184893033,0.05665112943707422
PVP01_0405700,759,15,28,802,0.9463840399002493,0.018703241895261846,0.034912718204488775
PVP01_0405600,1175,32,68,1275,0.9215686274509803,0.025098039215686273,0.05333333333333334
PVP01_0405400,1122,28,70,1220,0.919672131147541,0.022950819672131147,0.05737704918032787
PVP01_0405100,1868,1205,661,3734,0.5002678093197643,0.322710230316015,0.1770219603642207
PVP01_0837900,324,39,10,373,0.868632707774799,0.10455764075067024,0.02680965147453083
PVP01_0837800,2279,988,141,3408,0.6687206572769953,0.289906103286385,0.04137323943661972
PVP01_0837700,723,106,52,881,0.8206583427922814,0.12031782065834279,0.05902383654937571
PVP01_0837500,412,31,6,449,0.9175946547884187,0.06904231625835189,0.013363028953229399
PVP01_0837400,101,35,33,169,0.5976331360946746,0.20710059171597633,0.1952662721893491
PVP01_0837300,2312,84,277,2673,0.8649457538346427,0.031425364758698095,0.10362888140665918
PVP01_0837200,3982,425,153,4560,0.8732456140350877,0.09320175438596491,0.03355263157894737
PVP01_0837100,1146,324,35,1505,0.7614617940199335,0.21528239202657806,0.023255813953488372
PVP01_0837000,3944,367,1060,5371,0.7343139080245764,0.06832991994042077,0.1973561720350028
PVP01_0836900,353,96,28,477,0.740041928721174,0.20125786163522014,0.05870020964360587
PVP01_0836800,306,17,12,335,0.9134328358208955,0.050746268656716415,0.03582089552238806
PVP01_0836600,135,8,2,145,0.9310344827586207,0.05517241379310345,0.013793103448275862
PVP01_0836500,1851,36,190,2077,0.8911892152142513,0.017332691381800675,0.091478093403948
PVP01_0836400,520,8,189,717,0.7252440725244073,0.011157601115760111,0.26359832635983266
PVP01_0836300,20,3,146,169,0.11834319526627218,0.01775147928994083,0.863905325443787
PVP01_0836100,82,19,1792,1893,0.04331748547279451,0.010036978341257264,0.9466455361859483
PVP01_0836000,15,23,30,68,0.22058823529411764,0.3382352941176471,0.4411764705882353
PVP01_0835900,212,26,24,262,0.8091603053435115,0.09923664122137404,0.0916030534351145
PVP01_0835800,2912,1204,76,4192,0.6946564885496184,0.2872137404580153,0.01812977099236641
PVP01_0835400,432,47,16,495,0.8727272727272727,0.09494949494949495,0.03232323232323232
PVP01_0835300,686,239,21,946,0.7251585623678647,0.2526427061310782,0.022198731501057084
PVP01_0835200,605,37,21,663,0.9125188536953243,0.05580693815987934,0.03167420814479638
PVP01_0835000,592,364,405,1361,0.43497428361498897,0.2674504041146216,0.2975753122703894
PVP01_0834900,2675,1020,468,4163,0.6425654576026903,0.2450156137400913,0.11241892865721835
PVP01_0834800,354,34,84,472,0.75,0.07203389830508475,0.17796610169491525
PVP01_0834700,953,473,130,1556,0.6124678663239075,0.30398457583547556,0.08354755784061697
PVP01_0834600,2477,50,123,2650,0.9347169811320755,0.018867924528301886,0.04641509433962264
PVP01_0834500,2445,206,59,2710,0.9022140221402214,0.07601476014760147,0.021771217712177122
PVP01_0834400,185,28,14,227,0.8149779735682819,0.12334801762114538,0.06167400881057269
PVP01_0834200,90,5,45,140,0.6428571428571429,0.03571428571428571,0.32142857142857145
PVP01_0834000,1647,154,55,1856,0.8873922413793104,0.08297413793103449,0.029633620689655173
PVP01_0833900,1589,71,60,1720,0.9238372093023256,0.04127906976744186,0.03488372093023256
PVP01_0833800,4235,89,517,4841,0.8748192522206156,0.018384631274530057,0.10679611650485436
PVP01_0833700,252,14,25,291,0.865979381443299,0.048109965635738834,0.0859106529209622
PVP01_0833600,1041,33,55,1129,0.9220549158547388,0.029229406554472984,0.048715677590788306
PVP01_0833500,236,25,47,308,0.7662337662337663,0.08116883116883117,0.1525974025974026
PVP01_0833400,4204,376,111,4691,0.8961841824770838,0.08015348539756982,0.023662332125346408
PVP01_0833200,1436,657,51,2144,0.6697761194029851,0.3064365671641791,0.02378731343283582
PVP01_0833100,3011,1233,71,4315,0.6977983777520278,0.285747392815759,0.01645422943221321
PVP01_0833000,7906,3116,232,11254,0.7025057757241869,0.2768793317931402,0.020614892482672828
PVP01_0832900,23,12,2,37,0.6216216216216216,0.32432432432432434,0.05405405405405406
PVP01_0832800,899,70,127,1096,0.8202554744525548,0.06386861313868614,0.11587591240875912
PVP01_0832700,891,14,107,1012,0.8804347826086957,0.01383399209486166,0.10573122529644269
PVP01_0832500,2839,58,653,3550,0.7997183098591549,0.016338028169014085,0.18394366197183099
PVP01_0832200,449,15,11,475,0.9452631578947368,0.031578947368421054,0.023157894736842106
PVP01_0832000,5614,703,199,6516,0.8615715162676488,0.10788827501534684,0.030540208717004295
PVP01_0831700,239,39,6,284,0.8415492957746479,0.13732394366197184,0.02112676056338028
PVP01_0831600,69,9,4,82,0.8414634146341463,0.10975609756097561,0.04878048780487805
PVP01_0831500,7,0,266,273,0.02564102564102564,0,0.9743589743589743
PVP01_0831400,688,19,15,722,0.9529085872576177,0.02631578947368421,0.02077562326869806
PVP01_0831300,1562,332,43,1937,0.806401652039236,0.1713990707279298,0.02219927723283428
PVP01_0831200,235,15,17,267,0.8801498127340824,0.056179775280898875,0.06367041198501873
PVP01_0831100,1,0,0,1,1,0,0
PVP01_0830900,214,74,82,370,0.5783783783783784,0.2,0.22162162162162163
PVP01_0830700,428,122,10,560,0.7642857142857142,0.21785714285714286,0.017857142857142856
PVP01_0830600,10543,5018,720,16281,0.6475646459062712,0.3082120262883115,0.04422332780541736
PVP01_0830500,488,93,68,649,0.7519260400616333,0.14329738058551617,0.10477657935285054
PVP01_0830400,265,23,57,345,0.7681159420289855,0.06666666666666667,0.16521739130434782
PVP01_0830200,572,17,82,671,0.8524590163934426,0.02533532041728763,0.12220566318926974
PVP01_0829900,1368,386,38,1792,0.7633928571428571,0.21540178571428573,0.021205357142857144
PVP01_0829800,2489,48,318,2855,0.8718038528896672,0.01681260945709282,0.11138353765323993
PVP01_0829600,868,232,68,1168,0.7431506849315068,0.19863013698630136,0.05821917808219178
PVP01_0829500,13,2,7,22,0.5909090909090909,0.09090909090909091,0.3181818181818182
PVP01_0829400,270,44,94,408,0.6617647058823529,0.10784313725490197,0.23039215686274508
PVP01_0829100,1662,224,42,1928,0.8620331950207469,0.11618257261410789,0.021784232365145227
PVP01_0829000,1756,131,63,1950,0.9005128205128206,0.06717948717948719,0.03230769230769231
PVP01_0828900,2715,396,122,3233,0.8397772966285184,0.12248685431487782,0.03773584905660377
PVP01_0828700,29,8,0,37,0.7837837837837838,0.21621621621621623,0
PVP01_0828600,1098,42,52,1192,0.9211409395973155,0.03523489932885906,0.0436241610738255
PVP01_0828400,6291,146,262,6699,0.9390953873712494,0.02179429765636662,0.03911031497238394
PVP01_0828300,107,7,10,124,0.8629032258064516,0.056451612903225805,0.08064516129032258
PVP01_0828200,893,36,10,939,0.9510117145899893,0.038338658146964855,0.010649627263045794
PVP01_0828100,632,31,21,684,0.9239766081871345,0.04532163742690058,0.03070175438596491
PVP01_0828000,962,39,82,1083,0.8882733148661126,0.036011080332409975,0.07571560480147738
PVP01_0827900,781,57,25,863,0.9049826187717266,0.0660486674391657,0.028968713789107765
PVP01_0827700,794,211,940,1945,0.40822622107969153,0.10848329048843187,0.4832904884318766
PVP01_0827400,1555,848,78,2481,0.6267634018540911,0.3417976622329706,0.03143893591293833
PVP01_0827100,3658,310,89,4057,0.9016514666009366,0.07641114123736752,0.021937392161695834
PVP01_0827000,989,48,25,1062,0.931261770244821,0.04519774011299435,0.023540489642184557
PVP01_0826900,333,10,12,355,0.9380281690140845,0.028169014084507043,0.03380281690140845
PVP01_0826800,2259,460,546,3265,0.6918836140888208,0.14088820826952528,0.1672281776416539
PVP01_0826700,1228,172,65,1465,0.8382252559726963,0.1174061433447099,0.04436860068259386
PVP01_0826600,52,5,211,268,0.19402985074626866,0.018656716417910446,0.7873134328358209
PVP01_0826500,1647,46,42,1735,0.9492795389048991,0.026512968299711816,0.02420749279538905
PVP01_0826400,1326,29,30,1385,0.9574007220216606,0.020938628158844765,0.021660649819494584
PVP01_0826300,179,26,46,251,0.7131474103585658,0.10358565737051793,0.18326693227091634
PVP01_0826200,1293,90,129,1512,0.8551587301587301,0.05952380952380952,0.08531746031746032
PVP01_0825900,141,14,20,175,0.8057142857142857,0.08,0.11428571428571428
PVP01_0825700,18,6,5,29,0.6206896551724138,0.20689655172413793,0.1724137931034483
PVP01_0825600,168,166,14,348,0.4827586206896552,0.47701149425287354,0.040229885057471264
PVP01_0825500,1442,425,255,2122,0.6795475966069745,0.2002827521206409,0.12016965127238455
PVP01_0825100,861,20,18,899,0.9577308120133482,0.02224694104560623,0.020022246941045607
PVP01_0825000,59,17,1,77,0.7662337662337663,0.22077922077922077,0.012987012987012988
PVP01_0824900,3,0,1,4,0.75,0,0.25
PVP01_0824800,781,43,42,866,0.9018475750577367,0.049653579676674366,0.04849884526558892
PVP01_0824700,588,60,29,677,0.8685376661742984,0.08862629246676514,0.04283604135893648
PVP01_0824600,985,32,24,1041,0.9462055715658021,0.03073967339097022,0.023054755043227664
PVP01_0824400,670,77,212,959,0.6986444212721585,0.08029197080291971,0.2210636079249218
PVP01_0824200,17,6,25,48,0.3541666666666667,0.125,0.5208333333333334
PVP01_0824000,778,51,21,850,0.9152941176470588,0.06,0.024705882352941175
PVP01_0823800,426,25,12,463,0.9200863930885529,0.05399568034557235,0.02591792656587473
PVP01_0823700,1804,58,264,2126,0.8485418626528692,0.027281279397930385,0.12417685794920037
PVP01_0823600,766,14,312,1092,0.7014652014652014,0.01282051282051282,0.2857142857142857
PVP01_0823500,151,7,11,169,0.893491124260355,0.04142011834319527,0.0650887573964497
PVP01_0823400,519,20,40,579,0.8963730569948186,0.03454231433506045,0.0690846286701209
PVP01_0705000,669,104,55,828,0.8079710144927537,0.12560386473429952,0.06642512077294686
PVP01_0704900,134,11,37,182,0.7362637362637363,0.06043956043956044,0.2032967032967033
PVP01_0704800,1533,38,77,1648,0.9302184466019418,0.023058252427184466,0.046723300970873786
PVP01_0704700,1170,23,63,1256,0.9315286624203821,0.018312101910828025,0.05015923566878981
PVP01_0704600,413,12,85,510,0.8098039215686275,0.023529411764705882,0.16666666666666666
PVP01_0704500,2063,137,430,2630,0.7844106463878328,0.05209125475285171,0.1634980988593156
PVP01_0704300,1025,74,48,1147,0.8936355710549259,0.06451612903225806,0.041848299912816043
PVP01_0704100,473,32,88,593,0.7976391231028668,0.05396290050590219,0.14839797639123103
PVP01_0704000,72,0,5,77,0.935064935064935,0,0.06493506493506493
PVP01_0703900,13,0,16,29,0.4482758620689655,0,0.5517241379310345
PVP01_0703800,4153,79,376,4608,0.9012586805555556,0.017144097222222224,0.08159722222222222
PVP01_0703600,582,663,188,1433,0.4061409630146546,0.46266573621772505,0.13119330076762037
PVP01_0703500,304,36,35,375,0.8106666666666666,0.096,0.09333333333333334
PVP01_0703400,409,12,11,432,0.9467592592592593,0.027777777777777776,0.02546296296296296
PVP01_0703300,2302,108,62,2472,0.9312297734627831,0.043689320388349516,0.025080906148867314
PVP01_0703200,1524,27,33,1584,0.9621212121212122,0.017045454545454544,0.020833333333333332
PVP01_0703100,2015,35,106,2156,0.9346011131725418,0.016233766233766232,0.04916512059369202
PVP01_0702900,633,58,36,727,0.8707015130674003,0.07977991746905089,0.04951856946354883
PVP01_0702800,1059,96,43,1198,0.8839732888146912,0.08013355592654424,0.03589315525876461
PVP01_0702700,39,4,3,46,0.8478260869565217,0.08695652173913043,0.06521739130434782
PVP01_0702600,77,13,8,98,0.7857142857142857,0.1326530612244898,0.08163265306122448
PVP01_0702500,642,92,13,747,0.8594377510040161,0.12315930388219545,0.01740294511378849
PVP01_0702400,649,35,28,712,0.9115168539325843,0.04915730337078652,0.03932584269662921
PVP01_0702300,6678,3223,196,10097,0.6613845696741606,0.3192037238783797,0.019411706447459643
PVP01_0702200,30,5,3,38,0.7894736842105263,0.13157894736842105,0.07894736842105263
PVP01_0702000,1494,39,3855,5388,0.27728285077951004,0.007238307349665924,0.715478841870824
PVP01_0701800,2666,1222,93,3981,0.6696809846772168,0.30695805074101984,0.023360964581763375
PVP01_0701500,71,11,30,112,0.6339285714285714,0.09821428571428571,0.26785714285714285
PVP01_0701400,169,2,5,176,0.9602272727272727,0.011363636363636364,0.028409090909090908
PVP01_0602200,776,24,56,856,0.9065420560747663,0.028037383177570093,0.06542056074766354
PVP01_0602300,73,5,1881,1959,0.037263910158244005,0.002552322613578356,0.9601837672281777
PVP01_0602400,330,10,17,357,0.9243697478991597,0.028011204481792718,0.047619047619047616
PVP01_0602600,118,4,41,163,0.7239263803680982,0.024539877300613498,0.25153374233128833
PVP01_0602700,16,47,581,644,0.024844720496894408,0.07298136645962733,0.9021739130434783
PVP01_0603100,2342,146,44,2532,0.9249605055292259,0.05766192733017378,0.017377567140600316
PVP01_0603300,5,0,0,5,1,0,0
PVP01_0603500,3406,164,213,3783,0.9003436426116839,0.043351837166270155,0.056304520222045996
PVP01_0603700,234,111,9,354,0.6610169491525424,0.3135593220338983,0.025423728813559324
PVP01_0603800,915,1102,580,2597,0.3523296110897189,0.42433577204466694,0.22333461686561418
PVP01_0603900,117,41,19,177,0.6610169491525424,0.23163841807909605,0.10734463276836158
PVP01_0604200,807,120,101,1028,0.7850194552529183,0.11673151750972763,0.09824902723735408
PVP01_0604400,46,5,203,254,0.18110236220472442,0.01968503937007874,0.7992125984251969
PVP01_0604600,754,283,26,1063,0.70931326434619,0.2662276575729069,0.024459078080903106
PVP01_0604700,1142,37,70,1249,0.9143314651721377,0.029623698959167333,0.05604483586869496
PVP01_0604800,177,7,215,399,0.44360902255639095,0.017543859649122806,0.5388471177944862
PVP01_0605000,1684,187,43,1914,0.8798328108672936,0.09770114942528736,0.02246603970741902
PVP01_0605100,24,3,151,178,0.1348314606741573,0.016853932584269662,0.848314606741573
PVP01_0605200,480,536,734,1750,0.2742857142857143,0.30628571428571427,0.41942857142857143
PVP01_0605300,11,0,2,13,0.8461538461538461,0,0.15384615384615385
PVP01_0605400,122,21,30,173,0.7052023121387283,0.12138728323699421,0.17341040462427745
PVP01_0605500,321,4,27,352,0.9119318181818182,0.011363636363636364,0.07670454545454546
PVP01_0605600,1126,93,30,1249,0.9015212169735789,0.0744595676541233,0.02401921537229784
PVP01_0605700,2507,149,74,2730,0.9183150183150183,0.05457875457875458,0.027106227106227107
PVP01_0605800,270,49,71,390,0.6923076923076923,0.12564102564102564,0.18205128205128204
PVP01_0605900,1148,945,212,2305,0.4980477223427332,0.40997830802603036,0.09197396963123644
PVP01_0606000,93,5,0,98,0.9489795918367347,0.05102040816326531,0
PVP01_0606100,191,10,41,242,0.7892561983471075,0.04132231404958678,0.16942148760330578
PVP01_0606200,2547,59,57,2663,0.9564401051445738,0.022155463762673678,0.021404431092752536
PVP01_0606300,2113,214,126,2453,0.8613942111699959,0.08724011414594374,0.051365674684060336
PVP01_0606400,1825,74,463,2362,0.7726502963590178,0.03132938187976291,0.1960203217612193
PVP01_0606500,206,13,9,228,0.9035087719298246,0.05701754385964912,0.039473684210526314
PVP01_0606600,784,41,35,860,0.9116279069767442,0.047674418604651166,0.040697674418604654
PVP01_0606700,2570,1816,116,4502,0.5708573967125722,0.4033762772101288,0.02576632607729898
PVP01_0606800,1256,248,54,1558,0.8061617458279846,0.15917843388960207,0.03465982028241335
PVP01_0607000,1342,30,672,2044,0.6565557729941291,0.014677103718199608,0.3287671232876712
PVP01_0607300,328,224,13,565,0.5805309734513274,0.39646017699115044,0.023008849557522124
PVP01_0607400,21,6,0,27,0.7777777777777778,0.2222222222222222,0
PVP01_0607500,18,5,0,23,0.782608695652174,0.21739130434782608,0
PVP01_0607700,304,2,54,360,0.8444444444444444,0.005555555555555556,0.15
PVP01_0607800,757,134,22,913,0.8291347207009858,0.14676889375684557,0.024096385542168676
PVP01_0607900,11,0,116,127,0.08661417322834646,0,0.9133858267716536
PVP01_0608000,1463,52,158,1673,0.8744769874476988,0.031081888822474597,0.09444112372982666
PVP01_0608100,1274,24,70,1368,0.9312865497076024,0.017543859649122806,0.05116959064327485
PVP01_0608200,26,0,70,96,0.2708333333333333,0,0.7291666666666666
PVP01_0608500,108,8,2,118,0.9152542372881356,0.06779661016949153,0.01694915254237288
PVP01_0608600,115,4,1,120,0.9583333333333334,0.03333333333333333,0.008333333333333333
PVP01_0608700,1018,22,18,1058,0.9621928166351607,0.020793950850661626,0.017013232514177693
PVP01_0608800,504,10,8,522,0.9655172413793104,0.019157088122605363,0.01532567049808429
PVP01_0608900,4,0,0,4,1,0,0
PVP01_0609100,1652,1198,638,3488,0.4736238532110092,0.3434633027522936,0.18291284403669725
PVP01_0609200,2038,176,40,2254,0.904170363797693,0.07808340727595386,0.01774622892635315
PVP01_0609400,264,11,23,298,0.8859060402684564,0.03691275167785235,0.07718120805369127
PVP01_0609500,666,15,39,720,0.925,0.020833333333333332,0.05416666666666667
PVP01_0609700,129,4,5,138,0.9347826086956522,0.028985507246376812,0.036231884057971016
PVP01_0609800,454,63,11,528,0.8598484848484849,0.11931818181818182,0.020833333333333332
PVP01_0609900,1870,145,33,2048,0.9130859375,0.07080078125,0.01611328125
PVP01_0610000,1851,1810,88,3749,0.4937316617764737,0.48279541210989596,0.0234729261136303
PVP01_0610100,655,61,613,1329,0.4928517682468021,0.04589917231000752,0.4612490594431904
PVP01_0610200,787,240,65,1092,0.7206959706959707,0.21978021978021978,0.05952380952380952
PVP01_0610300,1988,44,335,2367,0.8398817068018589,0.018588931136459652,0.14152936206168146
PVP01_0610500,916,99,80,1095,0.8365296803652968,0.09041095890410959,0.0730593607305936
PVP01_0610700,519,13,251,783,0.6628352490421456,0.016602809706257982,0.3205619412515964
PVP01_0610800,268,20,23,311,0.8617363344051447,0.06430868167202572,0.07395498392282958
PVP01_0610900,2194,108,135,2437,0.9002872384078785,0.04431678292983176,0.0553959786622897
PVP01_0611000,76,2,15,93,0.8172043010752689,0.021505376344086023,0.16129032258064516
PVP01_0611300,361,89,8,458,0.7882096069868996,0.1943231441048035,0.017467248908296942
PVP01_0611400,428,28,7,463,0.9244060475161987,0.06047516198704104,0.01511879049676026
PVP01_0611500,214,22,5,241,0.8879668049792531,0.0912863070539419,0.02074688796680498
PVP01_0611600,80,5,11,96,0.8333333333333334,0.052083333333333336,0.11458333333333333
PVP01_0611700,9,1,4,14,0.6428571428571429,0.07142857142857142,0.2857142857142857
PVP01_0611900,250,129,14,393,0.6361323155216285,0.3282442748091603,0.035623409669211195
PVP01_0612200,2745,3027,166,5938,0.46227686089592457,0.5097675985180196,0.02795554058605591
PVP01_0612300,746,167,16,929,0.8030139935414424,0.1797631862217438,0.017222820236813777
PVP01_0612400,7531,3115,22226,32872,0.22910075444146993,0.09476149914821125,0.6761377464103188
PVP01_0612500,371,17,8,396,0.9368686868686869,0.04292929292929293,0.020202020202020204
PVP01_0612600,119,11,4,134,0.8880597014925373,0.08208955223880597,0.029850746268656716
PVP01_0612800,100,4,45,149,0.6711409395973155,0.026845637583892617,0.30201342281879195
PVP01_0612900,9646,4648,318,14612,0.6601423487544484,0.3180947166712291,0.021762934574322476
PVP01_0613000,8,5,2,15,0.5333333333333333,0.3333333333333333,0.13333333333333333
PVP01_0613100,207,67,152,426,0.4859154929577465,0.1572769953051643,0.3568075117370892
PVP01_0613200,67,24,20,111,0.6036036036036037,0.21621621621621623,0.18018018018018017
PVP01_0613300,106,6,3,115,0.9217391304347826,0.05217391304347826,0.02608695652173913
PVP01_0613400,571,1792,163,2526,0.22604908946951702,0.7094220110847189,0.06452889944576405
PVP01_0613500,428,1762,54,2244,0.19073083778966132,0.785204991087344,0.02406417112299465
PVP01_0613700,1071,29,631,1731,0.6187175043327556,0.016753321779318313,0.36452917388792605
PVP01_0613900,2933,75,891,3899,0.7522441651705566,0.01923570146191331,0.22852013336753013
PVP01_0614000,33,0,380,413,0.07990314769975787,0,0.9200968523002422
PVP01_0614200,82,11,61,154,0.5324675324675324,0.07142857142857142,0.3961038961038961
PVP01_0614300,14,13,0,27,0.5185185185185185,0.48148148148148145,0
PVP01_0614400,501,85,99,685,0.7313868613138687,0.12408759124087591,0.14452554744525548
PVP01_0614500,1641,155,1109,2905,0.5648881239242685,0.05335628227194492,0.3817555938037866
PVP01_0614600,62,1,2,65,0.9538461538461539,0.015384615384615385,0.03076923076923077
PVP01_0614700,1858,307,80,2245,0.8276169265033407,0.13674832962138084,0.035634743875278395
PVP01_0614800,60,0,27,87,0.6896551724137931,0,0.3103448275862069
PVP01_0614900,681,47,47,775,0.8787096774193548,0.06064516129032258,0.06064516129032258
PVP01_0615000,1075,74,1105,2254,0.4769299023957409,0.032830523513753325,0.4902395740905058
PVP01_0615100,511,202,131,844,0.6054502369668247,0.23933649289099526,0.1552132701421801
PVP01_0615300,2,2,78,82,0.024390243902439025,0.024390243902439025,0.9512195121951219
PVP01_0615500,78,9,2,89,0.8764044943820225,0.10112359550561797,0.02247191011235955
PVP01_0615600,1790,161,34,1985,0.9017632241813602,0.08110831234256927,0.01712846347607053
PVP01_0615800,103,23,2,128,0.8046875,0.1796875,0.015625
PVP01_0615900,208,13,320,541,0.3844731977818854,0.024029574861367836,0.5914972273567468
PVP01_0616200,218,15,16,249,0.8755020080321285,0.060240963855421686,0.0642570281124498
PVP01_0616300,25,6,820,851,0.02937720329024677,0.007050528789659225,0.963572267920094
PVP01_0616500,147,4,8,159,0.9245283018867925,0.025157232704402517,0.050314465408805034
PVP01_0616700,361,95,21,477,0.7568134171907757,0.19916142557651992,0.0440251572327044
PVP01_0616800,17,9,72,98,0.17346938775510204,0.09183673469387756,0.7346938775510204
PVP01_0616900,763,3,48,814,0.9373464373464373,0.0036855036855036856,0.05896805896805897
PVP01_0617000,166,4,19,189,0.8783068783068783,0.021164021164021163,0.10052910052910052
PVP01_0617100,1272,206,29,1507,0.8440610484406105,0.1366954213669542,0.019243530192435302
PVP01_0617300,22,2,11,35,0.6285714285714286,0.05714285714285714,0.3142857142857143
PVP01_0617500,2012,37,57,2106,0.9553656220322887,0.017568850902184234,0.027065527065527065
PVP01_0617600,126,14,3,143,0.8811188811188811,0.0979020979020979,0.02097902097902098
PVP01_0617700,214,37,7,258,0.8294573643410853,0.1434108527131783,0.027131782945736434
PVP01_0617900,173,17,11,201,0.8606965174129353,0.0845771144278607,0.05472636815920398
PVP01_0618000,1342,209,31,1582,0.8482932996207333,0.13211125158027812,0.019595448798988623
PVP01_0618100,413,26,9,448,0.921875,0.05803571428571429,0.020089285714285716
PVP01_0618200,204,174,31,409,0.49877750611246946,0.4254278728606357,0.07579462102689487
PVP01_0618400,22,5,1,28,0.7857142857142857,0.17857142857142858,0.03571428571428571
PVP01_0618600,331,133,44,508,0.6515748031496063,0.2618110236220472,0.08661417322834646
PVP01_0618700,2815,429,385,3629,0.7756957839625241,0.11821438412785891,0.10608983190961697
PVP01_0618800,96,79,17,192,0.5,0.4114583333333333,0.08854166666666667
PVP01_0618900,56,7,6,69,0.8115942028985508,0.10144927536231885,0.08695652173913043
PVP01_0619000,124,10,10,144,0.8611111111111112,0.06944444444444445,0.06944444444444445
PVP01_0619100,1226,118,69,1413,0.867657466383581,0.0835102618542109,0.04883227176220807
PVP01_0619200,2,0,0,2,1,0,0
PVP01_0619300,24,2,1,27,0.8888888888888888,0.07407407407407407,0.037037037037037035
PVP01_0619500,86,3,1,90,0.9555555555555556,0.03333333333333333,0.011111111111111112
PVP01_0619600,146,12,90,248,0.5887096774193549,0.04838709677419355,0.3629032258064516
PVP01_0619700,467,11,63,541,0.8632162661737524,0.02033271719038817,0.11645101663585952
PVP01_0619900,11,3,0,14,0.7857142857142857,0.21428571428571427,0
PVP01_0620100,830,251,34,1115,0.7443946188340808,0.22511210762331837,0.030493273542600896
PVP01_0621000,188,19,26,233,0.8068669527896996,0.0815450643776824,0.11158798283261803
PVP01_0621200,2268,83,102,2453,0.924582144313086,0.03383611903791276,0.04158173664900122
PVP01_0621500,765,26,13,804,0.9514925373134329,0.03233830845771144,0.01616915422885572
PVP01_0621600,132,0,2,134,0.9850746268656716,0,0.014925373134328358
PVP01_0621700,1782,1025,75,2882,0.6183206106870229,0.3556557945870923,0.0260235947258848
PVP01_0621900,87,0,213,300,0.29,0,0.71
PVP01_0622000,425,57,14,496,0.8568548387096774,0.11491935483870967,0.028225806451612902
PVP01_0622100,339,129,13,481,0.7047817047817048,0.2681912681912682,0.02702702702702703
PVP01_0622200,238,80,6,324,0.7345679012345679,0.24691358024691357,0.018518518518518517
PVP01_0622300,657,118,42,817,0.8041615667074663,0.14443084455324356,0.051407588739290085
PVP01_0622400,944,211,154,1309,0.721161191749427,0.16119174942704353,0.11764705882352941
PVP01_0622600,97,11,7,115,0.8434782608695652,0.09565217391304348,0.06086956521739131
PVP01_0622700,42,4,1,47,0.8936170212765957,0.0851063829787234,0.02127659574468085
PVP01_0529500,588,599,51,1238,0.47495961227786754,0.48384491114701134,0.04119547657512116
PVP01_0529700,2790,178,82,3050,0.9147540983606557,0.058360655737704915,0.026885245901639345
PVP01_0530000,61,1,11,73,0.8356164383561644,0.0136986301369863,0.1506849315068493
PVP01_0530100,2806,131,1098,4035,0.6954151177199505,0.03246592317224287,0.2721189591078067
PVP01_0530400,18,0,14,32,0.5625,0,0.4375
PVP01_0530500,578,11,24,613,0.9429037520391517,0.01794453507340946,0.03915171288743882
PVP01_0530700,2412,391,186,2989,0.8069588491134159,0.13081298093007696,0.06222816995650719
PVP01_0530900,5047,1953,154,7154,0.7054794520547946,0.27299412915851273,0.021526418786692758
PVP01_0531100,352,13,25,390,0.9025641025641026,0.03333333333333333,0.0641025641025641
PVP01_0531200,100,68,6,174,0.5747126436781609,0.39080459770114945,0.034482758620689655
PVP01_0531300,549,19,8,576,0.953125,0.03298611111111111,0.013888888888888888
PVP01_0531400,1133,40,49,1222,0.9271685761047463,0.03273322422258593,0.040098199672667756
PVP01_0531600,185,15,6,206,0.8980582524271845,0.07281553398058252,0.02912621359223301
PVP01_0531700,363,17,6,386,0.9404145077720207,0.04404145077720207,0.015544041450777202
PVP01_0532000,662,19,1743,2424,0.2731023102310231,0.007838283828382838,0.719059405940594
PVP01_0532100,1370,155,88,1613,0.8493490390576566,0.09609423434593925,0.05455672659640422
PVP01_1300800,1395,566,66,2027,0.6882091761223483,0.27923038973852987,0.03256043413912185
PVP01_1300900,146,9,11,166,0.8795180722891566,0.05421686746987952,0.06626506024096386
PVP01_1301000,21,1,2,24,0.875,0.041666666666666664,0.08333333333333333
PVP01_1301100,2799,197,577,3573,0.783375314861461,0.05513574027427932,0.16148894486425971
PVP01_1301300,564,41,82,687,0.8209606986899564,0.05967976710334789,0.11935953420669577
PVP01_1301500,1172,45,31,1248,0.9391025641025641,0.036057692307692304,0.024839743589743588
PVP01_1301600,184,11,7,202,0.9108910891089109,0.054455445544554455,0.034653465346534656
PVP01_1301700,67,5,1,73,0.9178082191780822,0.0684931506849315,0.0136986301369863
PVP01_1301800,1279,198,644,2121,0.603017444601603,0.09335219236209336,0.30363036303630364
PVP01_1301900,3096,177,519,3792,0.8164556962025317,0.04667721518987342,0.13686708860759494
PVP01_1302000,687,1078,71,1836,0.3741830065359477,0.5871459694989106,0.03867102396514161
PVP01_1302100,41,2,4,47,0.8723404255319149,0.0425531914893617,0.0851063829787234
PVP01_1302200,8176,185,4296,12657,0.6459666587659003,0.014616417792525874,0.3394169234415738
PVP01_1302300,1604,19,39,1662,0.9651022864019254,0.011432009626955475,0.023465703971119134
PVP01_1302500,114,9,5,128,0.890625,0.0703125,0.0390625
PVP01_1302600,4295,274,934,5503,0.7804833727057968,0.049791023078320916,0.16972560421588226
PVP01_1302800,144,209,5,358,0.4022346368715084,0.5837988826815642,0.013966480446927373
PVP01_1303000,2478,283,88,2849,0.8697788697788698,0.09933309933309933,0.03088803088803089
PVP01_1303100,661,188,83,932,0.7092274678111588,0.2017167381974249,0.0890557939914163
PVP01_1303200,0,1,0,1,0,1,0
PVP01_1303400,83,3,0,86,0.9651162790697675,0.03488372093023256,0
PVP01_1303500,966,390,29,1385,0.6974729241877257,0.2815884476534296,0.020938628158844765
PVP01_1303600,16,7,2,25,0.64,0.28,0.08
PVP01_1303700,1353,268,26,1647,0.8214936247723132,0.16272009714632665,0.015786278081360048
PVP01_1303800,911,148,24,1083,0.8411819021237303,0.13665743305632502,0.0221606648199446
PVP01_1303900,812,37,64,913,0.8893756845564075,0.040525739320920046,0.0700985761226725
PVP01_1304100,662,14,123,799,0.8285356695869838,0.017521902377972465,0.1539424280350438
PVP01_1304200,1184,134,22,1340,0.8835820895522388,0.1,0.016417910447761194
PVP01_1304300,75,2,275,352,0.21306818181818182,0.005681818181818182,0.78125
PVP01_1304400,1475,63,36,1574,0.9371029224904701,0.040025412960609914,0.022871664548919948
PVP01_1304600,163,317,152,632,0.2579113924050633,0.5015822784810127,0.24050632911392406
PVP01_1304700,12581,311,359,13251,0.9494377782808845,0.023469926797977513,0.027092294921138026
PVP01_1304800,262,12,26,300,0.8733333333333333,0.04,0.08666666666666667
PVP01_1305000,1172,59,264,1495,0.7839464882943143,0.03946488294314381,0.1765886287625418
PVP01_1305300,7064,3325,237,10626,0.6647844908714474,0.3129117259552042,0.022303783173348392
PVP01_1305500,292,10,143,445,0.6561797752808989,0.02247191011235955,0.32134831460674157
PVP01_1305600,86,3,4,93,0.9247311827956989,0.03225806451612903,0.043010752688172046
PVP01_1305800,575,304,76,955,0.6020942408376964,0.3183246073298429,0.07958115183246073
PVP01_1305900,671,41,16,728,0.9217032967032966,0.05631868131868132,0.02197802197802198
PVP01_1306200,1538,2074,313,3925,0.39184713375796176,0.5284076433121019,0.0797452229299363
PVP01_1306400,43,1,5,49,0.8775510204081632,0.02040816326530612,0.10204081632653061
PVP01_1306600,699,30,8,737,0.9484396200814111,0.0407055630936228,0.010854816824966078
PVP01_1306700,505,92,13,610,0.8278688524590164,0.15081967213114755,0.021311475409836064
PVP01_1306800,136,6,14,156,0.8717948717948718,0.038461538461538464,0.08974358974358974
PVP01_1307000,659,69,29,757,0.8705416116248349,0.09114927344782034,0.03830911492734478
PVP01_1307100,26,3,1,30,0.8666666666666667,0.1,0.03333333333333333
PVP01_1307300,417,11,62,490,0.8510204081632653,0.022448979591836733,0.12653061224489795
PVP01_1307400,1085,138,26,1249,0.8686949559647719,0.11048839071257005,0.020816653322658127
PVP01_1307700,73,4,1,78,0.9358974358974359,0.05128205128205128,0.01282051282051282
PVP01_1307800,1006,90,41,1137,0.8847845206684257,0.079155672823219,0.03605980650835532
PVP01_1308100,946,78,18,1042,0.9078694817658349,0.07485604606525911,0.01727447216890595
PVP01_1308300,2704,131,238,3073,0.8799219004230394,0.04262935242434104,0.0774487471526196
PVP01_1308500,161,6,375,542,0.29704797047970477,0.01107011070110701,0.6918819188191881
PVP01_1308600,33,0,41,74,0.44594594594594594,0,0.5540540540540541
PVP01_1308700,21,1,0,22,0.9545454545454546,0.045454545454545456,0
PVP01_1308800,517,15,151,683,0.7569546120058566,0.021961932650073207,0.22108345534407028
PVP01_1308900,131,4,10,145,0.903448275862069,0.027586206896551724,0.06896551724137931
PVP01_1309300,59,15,63,137,0.4306569343065693,0.10948905109489052,0.45985401459854014
PVP01_1309500,358,118,24,500,0.716,0.236,0.048
PVP01_1309700,2124,103,294,2521,0.8425228084093613,0.04085680285600952,0.11662038873462911
PVP01_1309800,496,29,43,568,0.8732394366197183,0.051056338028169015,0.07570422535211267
PVP01_1310000,349,9,10,368,0.9483695652173914,0.024456521739130436,0.02717391304347826
PVP01_1310100,301,30,11,342,0.8801169590643275,0.08771929824561403,0.03216374269005848
PVP01_1310400,2433,700,69,3202,0.7598376014990631,0.21861336664584635,0.021549031855090568
PVP01_1310500,721,13,17,751,0.9600532623169108,0.017310252996005325,0.022636484687083888
PVP01_1310600,1906,533,80,2519,0.7566494640730449,0.21159190154823343,0.031758634378721715
PVP01_1310700,769,188,83,1040,0.739423076923077,0.18076923076923077,0.0798076923076923
PVP01_1310900,1643,18,160,1821,0.9022515101592532,0.009884678747940691,0.08786381109280615
PVP01_1311000,367,26,127,520,0.7057692307692308,0.05,0.24423076923076922
PVP01_1311200,479,178,200,857,0.558926487747958,0.20770128354725786,0.23337222870478413
PVP01_1311300,1199,147,288,1634,0.7337821297429621,0.08996328029375765,0.1762545899632803
PVP01_1311500,3934,599,212,4745,0.8290832455216017,0.1262381454162276,0.04467860906217071
PVP01_1311600,2432,1603,317,4352,0.5588235294117647,0.36833639705882354,0.07284007352941177
PVP01_1311700,213,16,75,304,0.7006578947368421,0.05263157894736842,0.24671052631578946
PVP01_1311800,223,5,13,241,0.9253112033195021,0.02074688796680498,0.05394190871369295
PVP01_1311900,477,33,18,528,0.9034090909090909,0.0625,0.03409090909090909
PVP01_1312000,74,2,70,146,0.5068493150684932,0.0136986301369863,0.4794520547945205
PVP01_1312100,674,22,385,1081,0.6234967622571693,0.020351526364477335,0.3561517113783534
PVP01_1312200,110,18,2588,2716,0.04050073637702504,0.0066273932253313695,0.9528718703976435
PVP01_1312300,519,11,37,567,0.9153439153439153,0.019400352733686066,0.06525573192239859
PVP01_1312400,1112,17,18,1147,0.969485614646905,0.014821272885789015,0.015693112467306015
PVP01_1312500,656,110,35,801,0.818976279650437,0.1373283395755306,0.04369538077403246
PVP01_1312600,335,21,6,362,0.925414364640884,0.058011049723756904,0.016574585635359115
PVP01_1312700,814,42,98,954,0.8532494758909853,0.0440251572327044,0.10272536687631027
PVP01_1312800,381,14,47,442,0.8619909502262444,0.03167420814479638,0.10633484162895927
PVP01_0310400,254,14,4,272,0.9338235294117647,0.051470588235294115,0.014705882352941176
PVP01_0310500,824,111,180,1115,0.7390134529147983,0.09955156950672646,0.16143497757847533
PVP01_0311000,27,3,9,39,0.6923076923076923,0.07692307692307693,0.23076923076923078
PVP01_0311400,1423,33,440,1896,0.7505274261603375,0.01740506329113924,0.2320675105485232
PVP01_0311600,565,75,17,657,0.8599695585996956,0.1141552511415525,0.0258751902587519
PVP01_0311800,3168,2672,137,5977,0.5300317885226702,0.44704701355194915,0.022921197925380627
PVP01_0311900,997,1692,224,2913,0.34225883968417437,0.5808444902162719,0.07689667009955373
PVP01_0312000,332,1352,118,1802,0.18423973362930077,0.7502774694783574,0.06548279689234185
PVP01_0312200,2026,57,252,2335,0.8676659528907923,0.024411134903640257,0.10792291220556745
PVP01_0312300,470,23,23,516,0.9108527131782945,0.044573643410852716,0.044573643410852716
PVP01_0312400,2264,64,448,2776,0.8155619596541787,0.023054755043227664,0.16138328530259366
PVP01_0312500,712,149,45,906,0.7858719646799117,0.16445916114790288,0.04966887417218543
PVP01_0312600,52,26,1,79,0.6582278481012658,0.3291139240506329,0.012658227848101266
PVP01_0312700,5,1,0,6,0.8333333333333334,0.16666666666666666,0
PVP01_0312800,45,1,2,48,0.9375,0.020833333333333332,0.041666666666666664
PVP01_0312900,1232,164,190,1586,0.776796973518285,0.1034047919293821,0.11979823455233292
PVP01_0313000,1428,53,60,1541,0.9266709928617781,0.03439325113562622,0.03893575600259572
PVP01_0313100,1076,283,34,1393,0.7724335965541995,0.2031586503948313,0.024407753050969132
PVP01_0313300,1598,22,957,2577,0.6201008925106714,0.008537058595265812,0.3713620488940629
PVP01_0313400,297,7,337,641,0.46333853354134164,0.0109204368174727,0.5257410296411856
PVP01_0313700,763,78,19,860,0.8872093023255814,0.09069767441860466,0.022093023255813953
PVP01_0313900,1478,50,41,1569,0.9420012746972594,0.03186743148502231,0.026131293817718292
PVP01_0314000,4,1,1,6,0.6666666666666666,0.16666666666666666,0.16666666666666666
PVP01_0314200,671,56,15,742,0.9043126684636119,0.07547169811320754,0.02021563342318059
PVP01_0314400,836,30,19,885,0.9446327683615819,0.03389830508474576,0.021468926553672316
PVP01_0314700,203,12,8,223,0.9103139013452914,0.053811659192825115,0.03587443946188341
PVP01_0314800,1358,66,56,1480,0.9175675675675675,0.0445945945945946,0.03783783783783784
PVP01_0315000,485,102,33,620,0.782258064516129,0.16451612903225807,0.0532258064516129
PVP01_0315100,416,73,201,690,0.6028985507246377,0.10579710144927536,0.29130434782608694
PVP01_0315200,22,3,198,223,0.09865470852017937,0.013452914798206279,0.8878923766816144
PVP01_0315300,4749,2523,198,7470,0.6357429718875502,0.3377510040160643,0.02650602409638554
PVP01_0315400,5718,2218,183,8119,0.704273925360266,0.27318635299913785,0.022539721640596134
PVP01_0315500,2321,55,70,2446,0.9488961569910057,0.022485690923957483,0.028618152085036794
PVP01_0315700,571,61,11,643,0.8880248833592534,0.09486780715396578,0.017107309486780714
PVP01_0315800,1751,1235,567,3553,0.49282296650717705,0.34759358288770054,0.15958345060512244
PVP01_0315900,74,58,51,183,0.40437158469945356,0.31693989071038253,0.2786885245901639
PVP01_0316000,100,6,11,117,0.8547008547008547,0.05128205128205128,0.09401709401709402
PVP01_0316100,893,113,162,1168,0.764554794520548,0.09674657534246575,0.1386986301369863
PVP01_0316200,280,11,26,317,0.8832807570977917,0.03470031545741325,0.08201892744479496
PVP01_0316300,1486,151,89,1726,0.8609501738122828,0.08748551564310544,0.051564310544611816
PVP01_0316500,107,35,1,143,0.7482517482517482,0.24475524475524477,0.006993006993006993
PVP01_0316600,895,60,17,972,0.9207818930041153,0.06172839506172839,0.01748971193415638
PVP01_0316800,7516,726,163,8405,0.8942296252230815,0.08637715645449137,0.019393218322427127
PVP01_0316900,192,22,14,228,0.8421052631578947,0.09649122807017543,0.06140350877192982
PVP01_0317000,1231,1263,369,2863,0.42996856444289205,0.44114565141460005,0.12888578414250787
PVP01_0317100,189,13,6,208,0.9086538461538461,0.0625,0.028846153846153848
PVP01_0317300,9499,4067,276,13842,0.6862447623175841,0.29381592255454414,0.019939315127871695
PVP01_0317400,6,2,8,16,0.375,0.125,0.5
PVP01_0317500,2183,201,74,2458,0.888120423108218,0.08177379983726607,0.030105777054515868
PVP01_0317600,1029,119,275,1423,0.7231201686577653,0.08362614195361912,0.1932536893886156
PVP01_0317800,686,92,26,804,0.8532338308457711,0.11442786069651742,0.03233830845771144
PVP01_0317900,172,21,10120,10313,0.016677979249490934,0.002036264908368079,0.981285755842141
PVP01_0318000,2396,1229,329,3954,0.6059686393525544,0.3108244815376834,0.08320687910976227
PVP01_0318100,755,331,57,1143,0.6605424321959755,0.289588801399825,0.049868766404199474
PVP01_0318200,873,455,29,1357,0.6433308769344142,0.3352984524686809,0.021370670596904937
PVP01_0318300,2452,2520,1380,6352,0.38602015113350124,0.3967254408060453,0.2172544080604534
PVP01_0318400,527,99,415,1041,0.5062439961575408,0.09510086455331412,0.39865513928914503
PVP01_0318500,445,51,53,549,0.8105646630236795,0.09289617486338798,0.0965391621129326
PVP01_0318600,158,8,255,421,0.3752969121140142,0.019002375296912115,0.6057007125890737
PVP01_0318700,851,37,34,922,0.9229934924078091,0.04013015184381779,0.0368763557483731
PVP01_0318800,61,1,94,156,0.391025641025641,0.00641025641025641,0.6025641025641025
PVP01_0318900,6,0,10,16,0.375,0,0.625
PVP01_0319000,245,25,164,434,0.5645161290322581,0.0576036866359447,0.3778801843317972
PVP01_0319200,7,1,1,9,0.7777777777777778,0.1111111111111111,0.1111111111111111
PVP01_0319300,471,29,20,520,0.9057692307692308,0.05576923076923077,0.038461538461538464
PVP01_0319600,597,267,73,937,0.6371398078975453,0.2849519743863394,0.07790821771611527
PVP01_0319900,841,76,27,944,0.8908898305084746,0.08050847457627118,0.028601694915254237
PVP01_0320000,424,23,128,575,0.7373913043478261,0.04,0.22260869565217392
PVP01_0320100,16,3,0,19,0.8421052631578947,0.15789473684210525,0
PVP01_0320200,288,6,12,306,0.9411764705882353,0.0196078431372549,0.0392156862745098
PVP01_0320400,2316,500,391,3207,0.7221702525724977,0.15590894917368256,0.12192079825381977
PVP01_0320500,501,14,44,559,0.8962432915921288,0.025044722719141325,0.07871198568872988
PVP01_0320700,617,38,82,737,0.8371777476255088,0.051560379918588875,0.1112618724559023
PVP01_0320800,379,289,289,957,0.3960292580982236,0.3019853709508882,0.3019853709508882
PVP01_0320900,209,20,7,236,0.885593220338983,0.0847457627118644,0.029661016949152543
PVP01_0321000,1655,405,73,2133,0.7759024847632443,0.189873417721519,0.03422409751523676
PVP01_0321100,67,51,1756,1874,0.03575240128068303,0.027214514407684097,0.9370330843116329
PVP01_0838000,437,735,30,1202,0.36356073211314477,0.6114808652246256,0.024958402662229616
PVP01_0505000,5,0,110,115,0.043478260869565216,0,0.9565217391304348
PVP01_0505100,32,3,2,37,0.8648648648648649,0.08108108108108109,0.05405405405405406
PVP01_0505200,38,5,2,45,0.8444444444444444,0.1111111111111111,0.044444444444444446
PVP01_0505300,721,238,162,1121,0.6431757359500446,0.21231043710972347,0.14451382694023193
PVP01_0505400,282,131,43,456,0.618421052631579,0.28728070175438597,0.09429824561403509
PVP01_0505500,255,5,24,284,0.897887323943662,0.017605633802816902,0.08450704225352113
PVP01_0505600,7,1,113,121,0.05785123966942149,0.008264462809917356,0.9338842975206612
PVP01_0505700,1146,117,1316,2579,0.4443582784024816,0.045366421093447074,0.5102753005040713
PVP01_0505900,380,24,142,546,0.6959706959706959,0.04395604395604396,0.2600732600732601
PVP01_0506000,598,40,12,650,0.92,0.06153846153846154,0.018461538461538463
PVP01_0506100,1076,62,317,1455,0.7395189003436426,0.04261168384879725,0.21786941580756014
PVP01_0506200,1343,537,44,1924,0.6980249480249481,0.2791060291060291,0.02286902286902287
PVP01_0506300,131,8,17,156,0.8397435897435898,0.05128205128205128,0.10897435897435898
PVP01_0506500,8815,409,307,9531,0.9248767180778512,0.04291260098625538,0.0322106809358934
PVP01_0507000,53,8,5,66,0.803030303030303,0.12121212121212122,0.07575757575757576
PVP01_0507400,1339,1269,114,2722,0.4919177075679647,0.4662013225569434,0.04188096987509184
PVP01_0507600,2759,1182,75,4016,0.6870019920318725,0.29432270916334663,0.018675298804780877
PVP01_0507700,463,45,10,518,0.8938223938223938,0.08687258687258688,0.019305019305019305
PVP01_0507800,264,28,277,569,0.46397188049209137,0.0492091388400703,0.4868189806678383
PVP01_0507900,1406,34,101,1541,0.9123945489941596,0.022063595068137574,0.06554185593770279
PVP01_0508000,815,18,57,890,0.9157303370786517,0.020224719101123594,0.06404494382022471
PVP01_0508200,3362,1207,149,4718,0.7125900805426028,0.25582874099194575,0.031581178465451464
PVP01_0508300,1391,315,38,1744,0.7975917431192661,0.18061926605504589,0.021788990825688075
PVP01_0508500,41,5,5,51,0.803921568627451,0.09803921568627451,0.09803921568627451
PVP01_0508600,61,15,19,95,0.6421052631578947,0.15789473684210525,0.2
PVP01_0508700,487,16,11,514,0.9474708171206225,0.0311284046692607,0.021400778210116732
PVP01_0508800,1699,1995,125,3819,0.44488085886357687,0.5223880597014925,0.03273108143493061
PVP01_0508900,81,1,2,84,0.9642857142857143,0.011904761904761904,0.023809523809523808
PVP01_0509000,853,26,19,898,0.9498886414253898,0.028953229398663696,0.021158129175946547
PVP01_0509100,275,8,50,333,0.8258258258258259,0.024024024024024024,0.15015015015015015
PVP01_0509200,2,0,0,2,1,0,0
PVP01_0509400,1414,2006,448,3868,0.3655635987590486,0.5186142709410548,0.11582213029989659
PVP01_0509600,126,5,7,138,0.9130434782608695,0.036231884057971016,0.050724637681159424
PVP01_0509700,657,218,76,951,0.6908517350157729,0.22923238696109358,0.07991587802313355
PVP01_0509800,487,57,9,553,0.8806509945750453,0.10307414104882459,0.0162748643761302
PVP01_0509900,910,96,18,1024,0.888671875,0.09375,0.017578125
PVP01_0510000,1412,133,32,1577,0.8953709575142677,0.08433734939759036,0.020291693088142042
PVP01_0510100,2164,60,107,2331,0.9283569283569284,0.02574002574002574,0.045903045903045905
PVP01_0510200,734,57,64,855,0.8584795321637427,0.06666666666666667,0.07485380116959064
PVP01_0510400,351,153,79,583,0.6020583190394511,0.2624356775300172,0.13550600343053174
PVP01_0510500,362,16,6,384,0.9427083333333334,0.041666666666666664,0.015625
PVP01_0510600,2,0,0,2,1,0,0
PVP01_0510700,15,0,2,17,0.8823529411764706,0,0.11764705882352941
PVP01_0510800,105,20,24,149,0.7046979865771812,0.1342281879194631,0.1610738255033557
PVP01_0510900,17,4,1,22,0.7727272727272727,0.18181818181818182,0.045454545454545456
PVP01_0511000,5277,2114,521,7912,0.6669615773508595,0.2671890798786653,0.06584934277047523
PVP01_0511200,131,17,8,156,0.8397435897435898,0.10897435897435898,0.05128205128205128
PVP01_0511300,730,39,117,886,0.8239277652370203,0.04401805869074492,0.13205417607223477
PVP01_0511500,31,1,1,33,0.9393939393939394,0.030303030303030304,0.030303030303030304
PVP01_0511600,238,4,26,268,0.8880597014925373,0.014925373134328358,0.09701492537313433
PVP01_0511700,86,14,25,125,0.688,0.112,0.2
PVP01_0511800,20,4,40,64,0.3125,0.0625,0.625
PVP01_0511900,162,90,18,270,0.6,0.3333333333333333,0.06666666666666667
PVP01_0512000,804,88,11,903,0.8903654485049833,0.09745293466223699,0.012181616832779624
PVP01_0512200,820,54,14,888,0.9234234234234234,0.060810810810810814,0.015765765765765764
PVP01_0512300,2049,120,141,2310,0.887012987012987,0.05194805194805195,0.06103896103896104
PVP01_0512400,724,18,29,771,0.9390402075226978,0.023346303501945526,0.03761348897535668
PVP01_0512500,93,10,7,110,0.8454545454545455,0.09090909090909091,0.06363636363636363
PVP01_0512600,1193,520,35,1748,0.6824942791762014,0.2974828375286041,0.02002288329519451
PVP01_0512700,1149,178,41,1368,0.8399122807017544,0.1301169590643275,0.029970760233918127
PVP01_0512800,70,26,3,99,0.7070707070707071,0.26262626262626265,0.030303030303030304
PVP01_0512900,734,423,178,1335,0.5498127340823971,0.31685393258426964,0.13333333333333333
PVP01_0513000,1509,601,336,2446,0.6169255928045789,0.24570727718724447,0.1373671300081766
PVP01_0513100,1319,389,318,2026,0.6510365251727542,0.1920039486673248,0.15695952615992104
PVP01_0513300,110,4,23,137,0.8029197080291971,0.029197080291970802,0.1678832116788321
PVP01_0513400,211,14,64,289,0.7301038062283737,0.04844290657439446,0.22145328719723184
PVP01_0513500,468,29,83,580,0.8068965517241379,0.05,0.14310344827586208
PVP01_0513600,4251,125,301,4677,0.90891597177678,0.026726534103057517,0.06435749412016249
PVP01_0513700,97,0,23,120,0.8083333333333333,0,0.19166666666666668
PVP01_0513800,538,83,372,993,0.5417925478348439,0.08358509566968782,0.37462235649546827
PVP01_0513900,467,22,8,497,0.9396378269617707,0.04426559356136821,0.01609657947686117
PVP01_0514100,98,15,3,116,0.8448275862068966,0.12931034482758622,0.02586206896551724
PVP01_0514200,1110,218,63,1391,0.7979870596693026,0.15672178289000718,0.04529115744069015
PVP01_0010870,3864,455,559,4878,0.7921279212792128,0.09327593275932759,0.11459614596145962
PVP01_0514400,744,36,49,829,0.8974668275030157,0.04342581423401689,0.05910735826296743
PVP01_0514600,349,15,22,386,0.9041450777202072,0.038860103626943004,0.05699481865284974
PVP01_0514700,1482,133,711,2326,0.6371453138435081,0.05717970765262253,0.3056749785038693
PVP01_0514900,37,1,0,38,0.9736842105263158,0.02631578947368421,0
PVP01_0515000,233,23,3,259,0.8996138996138996,0.0888030888030888,0.011583011583011582
PVP01_0515100,4,4,3,11,0.36363636363636365,0.36363636363636365,0.2727272727272727
PVP01_0515200,86,69,11,166,0.5180722891566265,0.41566265060240964,0.06626506024096386
PVP01_0515500,671,1037,29,1737,0.38629821531375935,0.597006332757628,0.01669545192861255
PVP01_0516600,1749,48,455,2252,0.7766429840142096,0.021314387211367674,0.20204262877442272
PVP01_0516700,363,51,14,428,0.8481308411214953,0.1191588785046729,0.03271028037383177
PVP01_0516800,372,85,504,961,0.3870967741935484,0.08844953173777315,0.5244536940686785
PVP01_0516900,178,380,98,656,0.27134146341463417,0.5792682926829268,0.14939024390243902
PVP01_0517000,20,0,2,22,0.9090909090909091,0,0.09090909090909091
PVP01_0517100,847,36,67,950,0.891578947368421,0.037894736842105266,0.07052631578947369
PVP01_0517200,61,1,496,558,0.10931899641577061,0.0017921146953405018,0.8888888888888888
PVP01_0517300,78,195,11,284,0.2746478873239437,0.6866197183098591,0.03873239436619718
PVP01_0517400,144,246,18,408,0.35294117647058826,0.6029411764705882,0.04411764705882353
PVP01_0517500,36,1,21,58,0.6206896551724138,0.017241379310344827,0.3620689655172414
PVP01_0517600,1198,59,10437,11694,0.10244569864887977,0.00504532238754917,0.8925089789635711
PVP01_0517700,99,23,2970,3092,0.03201811125485123,0.007438551099611902,0.9605433376455369
PVP01_0517800,3118,128,49,3295,0.9462822458270106,0.038846737481031866,0.014871016691957511
PVP01_0517900,244,9,37,290,0.8413793103448276,0.03103448275862069,0.12758620689655173
PVP01_0518200,1796,154,164,2114,0.8495742667928098,0.0728476821192053,0.07757805108798486
PVP01_0518300,57,3,6,66,0.8636363636363636,0.045454545454545456,0.09090909090909091
PVP01_0518400,695,13,131,839,0.8283671036948749,0.015494636471990465,0.15613825983313467
PVP01_0518600,437,65,7,509,0.8585461689587426,0.12770137524557956,0.0137524557956778
PVP01_0518800,2,1,0,3,0.6666666666666666,0.3333333333333333,0
PVP01_0518900,175,13,2,190,0.9210526315789473,0.06842105263157895,0.010526315789473684
PVP01_0519000,105,1,23,129,0.813953488372093,0.007751937984496124,0.17829457364341086
PVP01_0519100,159,4,62,225,0.7066666666666667,0.017777777777777778,0.27555555555555555
PVP01_0519200,40,13,3,56,0.7142857142857143,0.23214285714285715,0.05357142857142857
PVP01_0519300,545,359,66,970,0.5618556701030928,0.37010309278350517,0.06804123711340206
PVP01_0519500,1134,217,558,1909,0.5940282870612886,0.11367207962283918,0.29229963331587216
PVP01_0519600,1821,68,75,1964,0.9271894093686355,0.034623217922606926,0.03818737270875764
PVP01_0519700,1862,698,99,2659,0.7002632568634826,0.26250470101541934,0.03723204212109816
PVP01_0519800,2505,26,230,2761,0.9072799710249909,0.009416877942774357,0.08330315103223469
PVP01_0519900,62,0,6,68,0.9117647058823529,0,0.08823529411764706
PVP01_0520000,2046,49,496,2591,0.7896565032805867,0.018911617136240833,0.1914318795831725
PVP01_0520100,1482,82,72,1636,0.9058679706601467,0.05012224938875306,0.044009779951100246
PVP01_0520200,104,19,25,148,0.7027027027027027,0.12837837837837837,0.16891891891891891
PVP01_0520300,1244,77,82,1403,0.8866714183891661,0.0548823948681397,0.05844618674269423
PVP01_0520400,1994,116,264,2374,0.8399326032013479,0.04886267902274642,0.11120471777590564
PVP01_0520500,5613,165,195,5973,0.939728779507785,0.027624309392265192,0.03264691109994977
PVP01_0520600,386,70,8,464,0.8318965517241379,0.15086206896551724,0.017241379310344827
PVP01_0520700,36,0,1,37,0.972972972972973,0,0.02702702702702703
PVP01_0520800,30,1,2,33,0.9090909090909091,0.030303030303030304,0.06060606060606061
PVP01_0521000,35,0,3,38,0.9210526315789473,0,0.07894736842105263
PVP01_0521100,666,19,707,1392,0.47844827586206895,0.013649425287356323,0.5079022988505747
PVP01_0521200,1568,72,632,2272,0.6901408450704225,0.03169014084507042,0.27816901408450706
PVP01_0521400,33,6,656,695,0.04748201438848921,0.008633093525179856,0.943884892086331
PVP01_0521500,282,39,54,375,0.752,0.104,0.144
PVP01_0521600,558,50,120,728,0.7664835164835165,0.06868131868131869,0.16483516483516483
PVP01_0521800,3443,1105,447,4995,0.6892892892892893,0.22122122122122123,0.0894894894894895
PVP01_0521900,653,86,119,858,0.7610722610722611,0.10023310023310024,0.1386946386946387
PVP01_0522000,626,130,74,830,0.7542168674698795,0.1566265060240964,0.0891566265060241
PVP01_0522100,213,22,30,265,0.8037735849056604,0.0830188679245283,0.11320754716981132
PVP01_0522200,469,16,12,497,0.9436619718309859,0.03219315895372234,0.02414486921529175
PVP01_0522400,1432,767,67,2266,0.6319505736981466,0.33848190644307147,0.029567519858781994
PVP01_0525500,1363,323,362,2048,0.66552734375,0.15771484375,0.1767578125
PVP01_0525600,488,142,98,728,0.6703296703296703,0.19505494505494506,0.1346153846153846
PVP01_0525700,279,5,9,293,0.9522184300341296,0.017064846416382253,0.030716723549488054
PVP01_0525800,2090,54,44,2188,0.9552102376599635,0.024680073126142597,0.02010968921389397
PVP01_0525900,76,7,7,90,0.8444444444444444,0.07777777777777778,0.07777777777777778
PVP01_0526000,623,87,18,728,0.8557692307692307,0.11950549450549451,0.024725274725274724
PVP01_0526100,60,2,50,112,0.5357142857142857,0.017857142857142856,0.44642857142857145
PVP01_0526200,106,9,95,210,0.5047619047619047,0.04285714285714286,0.4523809523809524
PVP01_0526300,1448,251,276,1975,0.7331645569620253,0.1270886075949367,0.13974683544303798
PVP01_0526500,10,0,0,10,1,0,0
PVP01_0526600,1946,32,185,2163,0.8996763754045307,0.014794267221451687,0.08552935737401757
PVP01_0526700,1388,303,270,1961,0.7078021417644059,0.15451300356960734,0.13768485466598673
PVP01_0526900,295,31,14,340,0.8676470588235294,0.09117647058823529,0.041176470588235294
PVP01_0527200,1171,47,268,1486,0.7880215343203231,0.031628532974428,0.180349932705249
PVP01_0527300,79,7,46,132,0.5984848484848485,0.05303030303030303,0.3484848484848485
PVP01_0527500,162,37,136,335,0.4835820895522388,0.11044776119402985,0.4059701492537313
PVP01_0527600,1199,317,72,1588,0.7550377833753149,0.1996221662468514,0.04534005037783375
PVP01_0527800,172,12,5,189,0.91005291005291,0.06349206349206349,0.026455026455026454
PVP01_0527900,103,6,31,140,0.7357142857142858,0.04285714285714286,0.22142857142857142
PVP01_0528100,1039,1725,170,2934,0.35412406271301977,0.5879345603271984,0.05794137695978187
PVP01_0528200,18,4,128,150,0.12,0.02666666666666667,0.8533333333333334
PVP01_0528300,38,0,302,340,0.11176470588235295,0,0.888235294117647
PVP01_0528400,138,323,115,576,0.23958333333333334,0.5607638888888888,0.1996527777777778
PVP01_0528500,406,39,240,685,0.5927007299270073,0.05693430656934306,0.35036496350364965
PVP01_0528600,24,8,4,36,0.6666666666666666,0.2222222222222222,0.1111111111111111
PVP01_0528700,60,11,0,71,0.8450704225352113,0.15492957746478872,0
PVP01_0528800,2210,619,67,2896,0.763121546961326,0.21374309392265192,0.0231353591160221
PVP01_0528900,896,35,139,1070,0.8373831775700935,0.03271028037383177,0.12990654205607477
PVP01_0529000,3059,291,121,3471,0.8813022183808701,0.08383751080380294,0.03486027081532699
PVP01_0529200,752,251,59,1062,0.7080979284369114,0.23634651600753295,0.05555555555555555
PVP01_0102800,3,8,1,12,0.25,0.6666666666666666,0.08333333333333333
PVP01_0103100,4,0,0,4,1,0,0
PVP01_0103300,380,58,114,552,0.6884057971014492,0.10507246376811594,0.20652173913043478
PVP01_0103400,851,79,70,1000,0.851,0.079,0.07
PVP01_0103500,12,1,3,16,0.75,0.0625,0.1875
PVP01_0103600,322,18,188,528,0.6098484848484849,0.03409090909090909,0.3560606060606061
PVP01_0103700,626,594,137,1357,0.4613117170228445,0.43773028739867353,0.10095799557848195
PVP01_0103800,471,11,529,1011,0.4658753709198813,0.010880316518298714,0.52324431256182
PVP01_0103900,44,14,2,60,0.7333333333333333,0.23333333333333334,0.03333333333333333
PVP01_0104400,1240,275,51,1566,0.7918263090676884,0.1756066411238825,0.032567049808429116
PVP01_0104600,524,75,60,659,0.795144157814871,0.11380880121396054,0.09104704097116843
PVP01_0104800,4607,1150,212,5969,0.7718210755570447,0.19266208745183447,0.03551683699112079
PVP01_0104900,555,11,87,653,0.8499234303215927,0.016845329249617153,0.1332312404287902
PVP01_0105100,314,28,6,348,0.9022988505747126,0.08045977011494253,0.017241379310344827
PVP01_0105200,1435,263,506,2204,0.6510889292196007,0.11932849364791288,0.2295825771324864
PVP01_0105500,1081,25,160,1266,0.8538704581358609,0.019747235387045814,0.1263823064770932
PVP01_0105600,3422,90,135,3647,0.9383054565396216,0.024677817384151358,0.03701672607622704
PVP01_0105800,475,39,15,529,0.8979206049149339,0.07372400756143667,0.02835538752362949
PVP01_0105900,919,357,28,1304,0.7047546012269938,0.2737730061349693,0.02147239263803681
PVP01_0106100,128,4,2,134,0.9552238805970149,0.029850746268656716,0.014925373134328358
PVP01_0106200,3524,905,92,4521,0.7794735677947356,0.20017695200176952,0.0203494802034948
PVP01_0106400,8,1,3,12,0.6666666666666666,0.08333333333333333,0.25
PVP01_0106600,345,136,8,489,0.7055214723926381,0.278118609406953,0.016359918200409
PVP01_0106800,574,47,8,629,0.9125596184419714,0.07472178060413355,0.012718600953895072
PVP01_0107600,810,374,46,1230,0.6585365853658537,0.3040650406504065,0.03739837398373984
PVP01_0107700,449,147,43,639,0.702660406885759,0.2300469483568075,0.06729264475743349
PVP01_0107800,588,127,18,733,0.8021828103683493,0.17326057298772168,0.02455661664392906
PVP01_0107900,1043,216,239,1498,0.6962616822429907,0.14419225634178906,0.1595460614152203
PVP01_0108000,985,52,25,1062,0.9274952919020716,0.04896421845574388,0.023540489642184557
PVP01_0108100,1358,949,115,2422,0.5606936416184971,0.3918249380677126,0.047481420313790254
PVP01_0108200,141,7,11,159,0.8867924528301887,0.0440251572327044,0.06918238993710692
PVP01_0108400,2025,603,129,2757,0.73449401523395,0.21871599564744287,0.046789989118607184
PVP01_0108500,776,43,24,843,0.9205219454329775,0.051008303677342826,0.028469750889679714
PVP01_0108600,320,20,7,347,0.9221902017291066,0.05763688760806916,0.020172910662824207
PVP01_0820700,396,35,11,442,0.8959276018099548,0.07918552036199095,0.024886877828054297
PVP01_0821000,2408,1255,87,3750,0.6421333333333333,0.33466666666666667,0.0232
PVP01_0821100,612,23,10,645,0.9488372093023256,0.03565891472868217,0.015503875968992248
PVP01_0821200,961,39,50,1050,0.9152380952380952,0.037142857142857144,0.047619047619047616
PVP01_0821300,705,83,26,814,0.8660933660933661,0.10196560196560196,0.03194103194103194
PVP01_0821400,643,37,22,702,0.915954415954416,0.05270655270655271,0.03133903133903134
PVP01_0821500,800,83,29,912,0.8771929824561403,0.09100877192982457,0.03179824561403509
PVP01_0821700,20,5,4,29,0.6896551724137931,0.1724137931034483,0.13793103448275862
PVP01_0821800,562,72,15,649,0.8659476117103235,0.11093990755007704,0.023112480739599383
PVP01_0822000,717,303,21,1041,0.6887608069164265,0.2910662824207493,0.020172910662824207
PVP01_0822200,485,23,10,518,0.9362934362934363,0.0444015444015444,0.019305019305019305
PVP01_0822300,510,30,13,553,0.9222423146473779,0.054249547920433995,0.023508137432188065
PVP01_0822400,777,62,206,1045,0.7435406698564593,0.05933014354066986,0.19712918660287082
PVP01_0822600,1634,76,389,2099,0.7784659361600762,0.03620771796093378,0.18532634587899
PVP01_0822900,725,8,153,886,0.8182844243792325,0.009029345372460496,0.172686230248307
PVP01_0823000,179,6,2,187,0.9572192513368984,0.03208556149732621,0.0106951871657754
PVP01_0823100,2401,115,146,2662,0.9019534184823441,0.043200601051840724,0.054845980465815174
PVP01_0823200,1502,344,568,2414,0.6222038111019056,0.14250207125103562,0.23529411764705882
PVP01_0705300,38,3,93,134,0.2835820895522388,0.022388059701492536,0.6940298507462687
PVP01_0705400,759,61,833,1653,0.4591651542649728,0.03690260133091349,0.5039322444041138
PVP01_0705500,331,22,30,383,0.8642297650130548,0.057441253263707574,0.0783289817232376
PVP01_0705600,832,68,21,921,0.9033659066232356,0.0738327904451683,0.02280130293159609
PVP01_0705700,1246,683,202,2131,0.5847020178320037,0.32050680431722195,0.09479117785077429
PVP01_0705800,361,14,8,383,0.9425587467362925,0.03655352480417755,0.020887728459530026
PVP01_0705900,3014,716,116,3846,0.7836713468538742,0.18616744669786792,0.03016120644825793
PVP01_0706100,772,43,22,837,0.9223416965352449,0.05137395459976105,0.026284348864994027
PVP01_0706200,1487,221,88,1796,0.8279510022271714,0.12305122494432072,0.04899777282850779
PVP01_0706300,266,22,28,316,0.8417721518987342,0.06962025316455696,0.08860759493670886
PVP01_0706400,1850,58,52,1960,0.9438775510204082,0.02959183673469388,0.026530612244897958
PVP01_0706500,859,7,336,1202,0.7146422628951747,0.005823627287853577,0.2795341098169717
PVP01_0706600,220,6,66,292,0.7534246575342466,0.02054794520547945,0.22602739726027396
PVP01_0706800,267,10,11,288,0.9270833333333334,0.034722222222222224,0.03819444444444445
PVP01_0707100,505,119,13,637,0.792778649921507,0.18681318681318682,0.02040816326530612
PVP01_0707200,863,80,112,1055,0.8180094786729858,0.07582938388625593,0.1061611374407583
PVP01_0707300,263,98,41,402,0.654228855721393,0.24378109452736318,0.10199004975124377
PVP01_0707400,329,65,79,473,0.6955602536997886,0.13742071881606766,0.16701902748414377
PVP01_0707600,46,1,12,59,0.7796610169491526,0.01694915254237288,0.2033898305084746
PVP01_0707700,108,3,19,130,0.8307692307692308,0.023076923076923078,0.14615384615384616
PVP01_0707800,268,129,9,406,0.6600985221674877,0.31773399014778325,0.022167487684729065
PVP01_0707900,2413,641,72,3126,0.77191298784389,0.20505438259756878,0.023032629558541268
PVP01_0708000,20,4,3,27,0.7407407407407407,0.14814814814814814,0.1111111111111111
PVP01_0708100,313,8,50,371,0.8436657681940701,0.0215633423180593,0.1347708894878706
PVP01_0708300,654,104,23,781,0.8373879641485276,0.13316261203585147,0.029449423815621
PVP01_0708600,1287,82,152,1521,0.8461538461538461,0.05391190006574622,0.09993425378040763
PVP01_0708800,573,100,15,688,0.8328488372093024,0.14534883720930233,0.02180232558139535
PVP01_0708900,624,75,26,725,0.8606896551724138,0.10344827586206896,0.03586206896551724
PVP01_0709100,48,0,38,86,0.5581395348837209,0,0.4418604651162791
PVP01_0709200,7,4,0,11,0.6363636363636364,0.36363636363636365,0
PVP01_0709400,651,26,13,690,0.9434782608695652,0.03768115942028986,0.01884057971014493
PVP01_0709500,89,2,10,101,0.8811881188118812,0.019801980198019802,0.09900990099009901
PVP01_0709600,30,9,1945,1984,0.015120967741935484,0.0045362903225806455,0.9803427419354839
PVP01_0709700,940,9,35,984,0.9552845528455285,0.009146341463414634,0.03556910569105691
PVP01_0709900,492,64,10,566,0.8692579505300353,0.11307420494699646,0.0176678445229682
PVP01_0710000,207,14,16,237,0.8734177215189873,0.05907172995780591,0.06751054852320675
PVP01_0710200,2094,158,35,2287,0.9156099693922168,0.06908613904678618,0.01530389156099694
PVP01_0710300,846,49,24,919,0.9205658324265505,0.05331882480957562,0.026115342763873776
PVP01_0710400,2713,471,508,3692,0.7348320693391116,0.12757313109425786,0.13759479956663057
PVP01_0710600,850,158,20,1028,0.8268482490272373,0.15369649805447472,0.019455252918287938
PVP01_0710700,126,1,86,213,0.5915492957746479,0.004694835680751174,0.40375586854460094
PVP01_0710800,740,36,87,863,0.8574739281575898,0.04171494785631518,0.10081112398609501
PVP01_0710900,2312,300,225,2837,0.8149453648219951,0.10574550581600282,0.07930912936200211
PVP01_0711100,342,33,6,381,0.8976377952755905,0.08661417322834646,0.015748031496062992
PVP01_0711200,464,245,18,727,0.6382393397524071,0.33700137551581844,0.024759284731774415
PVP01_0711300,1533,76,45,1654,0.9268440145102781,0.045949214026602174,0.02720677146311971
PVP01_0711400,195,220,17,432,0.4513888888888889,0.5092592592592593,0.03935185185185185
PVP01_0711500,129,14,6,149,0.8657718120805369,0.09395973154362416,0.040268456375838924
PVP01_0711700,1073,145,20,1238,0.8667205169628432,0.11712439418416801,0.01615508885298869
PVP01_0711800,88,4,36,128,0.6875,0.03125,0.28125
PVP01_0711900,409,16,7,432,0.9467592592592593,0.037037037037037035,0.016203703703703703
PVP01_0712000,711,38,19,768,0.92578125,0.049479166666666664,0.024739583333333332
PVP01_0712100,936,72,20,1028,0.9105058365758755,0.07003891050583658,0.019455252918287938
PVP01_0712200,12,44,44,100,0.12,0.44,0.44
PVP01_0712300,1699,119,117,1935,0.8780361757105943,0.06149870801033592,0.06046511627906977
PVP01_0712600,802,98,29,929,0.8632938643702907,0.1054897739504844,0.031216361679224973
PVP01_0712700,1109,568,103,1780,0.6230337078651685,0.31910112359550563,0.05786516853932584
PVP01_0712800,12,2,468,482,0.024896265560165973,0.004149377593360996,0.970954356846473
PVP01_0713000,214,38,120,372,0.5752688172043011,0.10215053763440861,0.3225806451612903
PVP01_0713100,14,1,11,26,0.5384615384615384,0.038461538461538464,0.4230769230769231
PVP01_0713400,332,21,56,409,0.8117359413202934,0.05134474327628362,0.13691931540342298
PVP01_0713500,664,82,16,762,0.8713910761154856,0.10761154855643044,0.02099737532808399
PVP01_0713600,128,5,1,134,0.9552238805970149,0.03731343283582089,0.007462686567164179
PVP01_0713700,424,76,13,513,0.8265107212475633,0.14814814814814814,0.025341130604288498
PVP01_0713800,240,144,13,397,0.6045340050377834,0.36272040302267,0.0327455919395466
PVP01_0713900,261,82,11,354,0.7372881355932204,0.23163841807909605,0.031073446327683617
PVP01_0714000,347,279,198,824,0.4211165048543689,0.33859223300970875,0.24029126213592233
PVP01_0714100,734,15,299,1048,0.700381679389313,0.01431297709923664,0.28530534351145037
PVP01_0714200,130,9,93,232,0.5603448275862069,0.03879310344827586,0.40086206896551724
PVP01_0714300,840,60,50,950,0.8842105263157894,0.06315789473684211,0.05263157894736842
PVP01_0714400,176,3,440,619,0.284329563812601,0.004846526655896607,0.7108239095315024
PVP01_0714500,53,4,43,100,0.53,0.04,0.43
PVP01_0714600,451,115,54,620,0.7274193548387097,0.18548387096774194,0.08709677419354839
PVP01_0714700,62,2,362,426,0.14553990610328638,0.004694835680751174,0.8497652582159625
PVP01_0714900,619,19,12,650,0.9523076923076923,0.02923076923076923,0.018461538461538463
PVP01_0715000,215,237,66,518,0.41505791505791506,0.4575289575289575,0.1274131274131274
PVP01_0715100,72,45,17,134,0.5373134328358209,0.3358208955223881,0.12686567164179105
PVP01_0715200,15,0,0,15,1,0,0
PVP01_0715300,2059,1635,559,4253,0.48412885022337176,0.38443451681166235,0.1314366329649659
PVP01_0715400,2046,37,82,2165,0.9450346420323326,0.017090069284064664,0.03787528868360277
PVP01_0715500,683,30,45,758,0.9010554089709762,0.0395778364116095,0.059366754617414245
PVP01_0715600,33,2,2,37,0.8918918918918919,0.05405405405405406,0.05405405405405406
PVP01_0715700,40,0,78,118,0.3389830508474576,0,0.6610169491525424
PVP01_0715900,2135,35,494,2664,0.8014264264264265,0.013138138138138139,0.18543543543543545
PVP01_0716100,103,44,5,152,0.6776315789473685,0.2894736842105263,0.03289473684210526
PVP01_0716200,67,3,4,74,0.9054054054054054,0.04054054054054054,0.05405405405405406
PVP01_0716400,1155,18,1965,3138,0.36806883365200765,0.0057361376673040155,0.6261950286806883
PVP01_0716500,286,62,41,389,0.7352185089974294,0.15938303341902313,0.10539845758354756
PVP01_0716700,784,304,25,1113,0.7044025157232704,0.27313566936208444,0.022461814914645103
PVP01_0716800,102,30,4,136,0.75,0.22058823529411764,0.029411764705882353
PVP01_0717000,694,10,82,786,0.8829516539440203,0.01272264631043257,0.10432569974554708
PVP01_0717200,469,319,18,806,0.5818858560794045,0.3957816377171216,0.022332506203473945
PVP01_0717300,237,56,54,347,0.6829971181556196,0.16138328530259366,0.15561959654178675
PVP01_0717400,3872,1468,168,5508,0.7029774872912128,0.2665214233841685,0.030501089324618737
PVP01_0717500,409,51,24,484,0.8450413223140496,0.10537190082644628,0.049586776859504134
PVP01_0717700,16,2,12,30,0.5333333333333333,0.06666666666666667,0.4
PVP01_0717800,859,23,42,924,0.9296536796536796,0.024891774891774892,0.045454545454545456
PVP01_0717900,4,0,7,11,0.36363636363636365,0,0.6363636363636364
PVP01_0718000,374,82,42,498,0.751004016064257,0.1646586345381526,0.08433734939759036
PVP01_0718100,203,26,23,252,0.8055555555555556,0.10317460317460317,0.09126984126984126
PVP01_0718200,853,53,442,1348,0.6327893175074184,0.039317507418397624,0.327893175074184
PVP01_0718500,137,33,5,175,0.7828571428571428,0.18857142857142858,0.02857142857142857
PVP01_0718600,1320,52,36,1408,0.9375,0.036931818181818184,0.02556818181818182
PVP01_0718700,247,17,17,281,0.8790035587188612,0.060498220640569395,0.060498220640569395
PVP01_0718800,264,14,10,288,0.9166666666666666,0.04861111111111111,0.034722222222222224
PVP01_0718900,19,5,9,33,0.5757575757575758,0.15151515151515152,0.2727272727272727
PVP01_0719100,2101,198,329,2628,0.7994672754946728,0.07534246575342465,0.1251902587519026
PVP01_0719200,611,212,17,840,0.7273809523809524,0.2523809523809524,0.02023809523809524
PVP01_0719300,942,125,28,1095,0.8602739726027397,0.1141552511415525,0.025570776255707764
PVP01_0719400,851,78,47,976,0.8719262295081968,0.07991803278688525,0.04815573770491803
PVP01_0719600,252,11,111,374,0.6737967914438503,0.029411764705882353,0.2967914438502674
PVP01_0719800,306,33,23,362,0.8453038674033149,0.09116022099447514,0.06353591160220995
PVP01_0719900,186,5,62,253,0.7351778656126482,0.019762845849802372,0.2450592885375494
PVP01_0720000,1165,28,457,1650,0.706060606060606,0.01696969696969697,0.276969696969697
PVP01_0720100,421,127,21,569,0.7398945518453427,0.22319859402460457,0.03690685413005272
PVP01_0720200,1349,52,115,1516,0.8898416886543535,0.03430079155672823,0.0758575197889182
PVP01_0720300,885,856,98,1839,0.4812398042414356,0.46547036432843936,0.05328983143012507
PVP01_0720400,3311,2019,203,5533,0.5984095427435387,0.36490150009036687,0.03668895716609434
PVP01_0720500,66,12,5,83,0.7951807228915663,0.14457831325301204,0.060240963855421686
PVP01_0720700,82,238,211,531,0.1544256120527307,0.448210922787194,0.3973634651600753
PVP01_0720800,2,0,0,2,1,0,0
PVP01_0720900,425,56,12,493,0.8620689655172413,0.11359026369168357,0.02434077079107505
PVP01_0721000,6863,1410,295,8568,0.8010037348272643,0.1645658263305322,0.03443043884220355
PVP01_0721100,561,157,124,842,0.666270783847981,0.18646080760095013,0.14726840855106887
PVP01_0721200,554,151,29,734,0.7547683923705722,0.20572207084468666,0.039509536784741145
PVP01_0721400,67,1,0,68,0.9852941176470589,0.014705882352941176,0
PVP01_0721500,501,97,20,618,0.8106796116504854,0.156957928802589,0.032362459546925564
PVP01_0721600,41,3,31,75,0.5466666666666666,0.04,0.41333333333333333
PVP01_0721700,86,69,13,168,0.5119047619047619,0.4107142857142857,0.07738095238095238
PVP01_0722100,75,1,26,102,0.7352941176470589,0.00980392156862745,0.2549019607843137
PVP01_0722200,20,2,0,22,0.9090909090909091,0.09090909090909091,0
PVP01_0722300,1266,59,74,1399,0.9049320943531094,0.04217298070050036,0.05289492494639028
PVP01_0722400,476,193,37,706,0.6742209631728046,0.273371104815864,0.05240793201133145
PVP01_0722500,566,87,226,879,0.6439135381114903,0.09897610921501707,0.2571103526734926
PVP01_0722600,1764,548,38,2350,0.7506382978723404,0.23319148936170211,0.016170212765957447
PVP01_0722700,189,26,4,219,0.863013698630137,0.1187214611872146,0.0182648401826484
PVP01_0722800,270,42,40,352,0.7670454545454546,0.11931818181818182,0.11363636363636363
PVP01_0723000,695,18,318,1031,0.6741028128031038,0.01745877788554801,0.3084384093113482
PVP01_0723200,784,263,179,1226,0.6394779771615008,0.21451876019575855,0.14600326264274063
PVP01_0723500,116,1,14,131,0.8854961832061069,0.007633587786259542,0.10687022900763359
PVP01_0723700,1972,549,108,2629,0.7500950931913275,0.20882464815519208,0.04108025865348041
PVP01_0723800,1756,216,152,2124,0.8267419962335216,0.1016949152542373,0.07156308851224105
PVP01_0723900,276,6,11,293,0.9419795221843004,0.020477815699658702,0.03754266211604096
PVP01_0724000,258,15,21,294,0.8775510204081632,0.05102040816326531,0.07142857142857142
PVP01_0724100,1368,61,91,1520,0.9,0.04013157894736842,0.05986842105263158
PVP01_0724200,514,43,43,600,0.8566666666666667,0.07166666666666667,0.07166666666666667
PVP01_0724300,141,14,52,207,0.6811594202898551,0.06763285024154589,0.25120772946859904
PVP01_0724400,1114,772,38,1924,0.579002079002079,0.40124740124740127,0.01975051975051975
PVP01_0724600,623,268,50,941,0.6620616365568545,0.28480340063761955,0.053134962805526036
PVP01_0724700,324,52,224,600,0.54,0.08666666666666667,0.37333333333333335
PVP01_0725000,318,65,110,493,0.6450304259634888,0.13184584178498987,0.2231237322515213
PVP01_0725200,3458,885,237,4580,0.7550218340611353,0.19323144104803494,0.051746724890829696
PVP01_0725400,1522,59,52,1633,0.9320269442743417,0.036129822412737295,0.03184323331292101
PVP01_0725500,576,15,73,664,0.8674698795180723,0.022590361445783132,0.10993975903614457
PVP01_0725600,153,3,5,161,0.9503105590062112,0.018633540372670808,0.031055900621118012
PVP01_0725800,555,12,349,916,0.6058951965065502,0.013100436681222707,0.38100436681222705
PVP01_0725900,173,5,8,186,0.9301075268817204,0.026881720430107527,0.043010752688172046
PVP01_0726000,90,1,16,107,0.8411214953271028,0.009345794392523364,0.14953271028037382
PVP01_0726100,682,28,88,798,0.85463659147869675,0.03508771929824561,0.11027568922305764
PVP01_0726200,407,19,68,494,0.8238866396761133,0.038461538461538464,0.13765182186234817
PVP01_0726300,793,22,191,1006,0.7882703777335984,0.02186878727634195,0.18986083499005965
PVP01_0726400,192,5,32,229,0.8384279475982532,0.021834061135371178,0.13973799126637554
PVP01_0726500,160,4,80,244,0.6557377049180327,0.01639344262295082,0.32786885245901637
PVP01_0726700,302,31,74,407,0.742014742014742,0.07616707616707617,0.18181818181818182
PVP01_0726800,2289,178,507,2974,0.7696704774714189,0.05985205110961668,0.17047747141896435
PVP01_0726900,165,5,35,205,0.8048780487804879,0.024390243902439025,0.17073170731707318
PVP01_0727000,443,76,452,971,0.45623069001029865,0.07826982492276004,0.4654994850669413
PVP01_0727100,68,9,3,80,0.85,0.1125,0.0375
PVP01_0727300,61,12,6,79,0.7721518987341772,0.1518987341772152,0.0759493670886076
PVP01_0727400,234,534,16,784,0.29846938775510207,0.6811224489795918,0.02040816326530612
PVP01_0727500,2184,153,143,2480,0.8806451612903226,0.06169354838709677,0.05766129032258065
PVP01_0727600,244,11,6,261,0.9348659003831418,0.0421455938697318,0.022988505747126436
PVP01_0727700,331,46,6,383,0.8642297650130548,0.12010443864229765,0.015665796344647518
PVP01_0727900,2972,90,125,3187,0.9325384374019454,0.028239723878255414,0.03922183871979919
PVP01_0728000,14,0,18,32,0.4375,0,0.5625
PVP01_0728100,49,9,33,91,0.5384615384615384,0.0989010989010989,0.3626373626373626
PVP01_0728200,245,10,14,269,0.9107806691449815,0.03717472118959108,0.05204460966542751
PVP01_0728300,346,8,8,362,0.9558011049723757,0.022099447513812154,0.022099447513812154
PVP01_0728400,324,7,50,381,0.8503937007874016,0.01837270341207349,0.13123359580052493
PVP01_0728500,7,2,0,9,0.7777777777777778,0.2222222222222222,0
PVP01_0728600,1182,88,45,1315,0.8988593155893536,0.06692015209125475,0.034220532319391636
PVP01_0728700,33,2,74,109,0.30275229357798167,0.01834862385321101,0.6788990825688074
PVP01_0728900,22526,597,60408,83531,0.2696723372161234,0.007147047204032036,0.7231806155798446
PVP01_0729000,269,45,92,406,0.6625615763546798,0.11083743842364532,0.22660098522167488
PVP01_0729200,2036,372,93,2501,0.8140743702518992,0.1487405037984806,0.03718512594962015
PVP01_0729300,653,74,35,762,0.8569553805774278,0.09711286089238845,0.045931758530183726
PVP01_0729400,458,46,114,618,0.7411003236245954,0.0744336569579288,0.18446601941747573
PVP01_0729600,463,21,14,498,0.929718875502008,0.04216867469879518,0.028112449799196786
PVP01_0729700,276,96,31,403,0.684863523573201,0.23821339950372208,0.07692307692307693
PVP01_0729800,638,936,59,1633,0.39069197795468463,0.5731781996325781,0.036129822412737295
PVP01_0729900,57,18,2,77,0.7402597402597403,0.23376623376623376,0.025974025974025976
PVP01_0730100,3967,239,220,4426,0.8962946226841392,0.053999096249435156,0.04970628106642567
PVP01_0730200,19,3,15,37,0.5135135135135135,0.08108108108108109,0.40540540540540543
PVP01_0730300,593,87,193,873,0.6792668957617412,0.09965635738831616,0.22107674684994272
PVP01_0730400,713,25,26,764,0.9332460732984293,0.032722513089005235,0.034031413612565446
PVP01_0730500,636,49,10,695,0.9151079136690647,0.07050359712230216,0.014388489208633094
PVP01_0730600,4,2,118,124,0.03225806451612903,0.016129032258064516,0.9516129032258065
PVP01_0730700,36,23,3048,3107,0.011586739620212423,0.007402639201802382,0.9810106211779852
PVP01_0730800,2707,94,1827,4628,0.5849178910976663,0.02031114952463267,0.39477095937770096
PVP01_0730900,316,9,112,437,0.7231121281464531,0.020594965675057208,0.2562929061784897
PVP01_0731000,776,109,17,902,0.8603104212860311,0.12084257206208426,0.018847006651884702
PVP01_0731200,1677,48,164,1889,0.8877713075701429,0.02541026998411858,0.08681842244573848
PVP01_0731400,604,227,109,940,0.6425531914893617,0.24148936170212765,0.11595744680851064
PVP01_0731500,453,53,95,601,0.7537437603993344,0.08818635607321132,0.15806988352745424
PVP01_0731600,74,5,4,83,0.891566265060241,0.060240963855421686,0.04819277108433735
PVP01_0731800,147,11,18,176,0.8352272727272727,0.0625,0.10227272727272728
PVP01_0731900,869,51,66,986,0.8813387423935092,0.05172413793103448,0.06693711967545639
PVP01_0732000,991,38,45,1074,0.9227188081936686,0.035381750465549346,0.04189944134078212
PVP01_0732100,364,24,151,539,0.6753246753246753,0.04452690166975881,0.28014842300556586
PVP01_0732200,3222,137,271,3630,0.8876033057851239,0.03774104683195592,0.0746556473829201
PVP01_0732300,1804,138,112,2054,0.878286270691334,0.06718597857838364,0.054527750730282376
PVP01_0732400,236,1,1,238,0.9915966386554622,0.004201680672268907,0.004201680672268907
PVP01_0732500,168,4,4,176,0.9545454545454546,0.022727272727272728,0.022727272727272728
PVP01_0732600,1491,186,189,1866,0.7990353697749196,0.09967845659163987,0.10128617363344052
PVP01_0732800,1347,134,456,1937,0.6954052658750646,0.06917914300464637,0.23541559112028912
PVP01_0732900,945,37,49,1031,0.9165858389912707,0.03588748787584869,0.0475266731328807
PVP01_0733000,119,1,5,125,0.952,0.008,0.04
PVP01_0733100,1542,51,52,1645,0.9373860182370821,0.03100303951367781,0.031610942249240125
PVP01_0733200,1056,191,156,1403,0.7526728439059159,0.1361368496079829,0.11119030648610122
PVP01_0733300,15,34,117,166,0.09036144578313253,0.20481927710843373,0.7048192771084337
PVP01_0733400,1871,79,1193,3143,0.5952911231307668,0.02513522112631244,0.3795736557429208
PVP01_0733500,155,3,201,359,0.43175487465181056,0.008356545961002786,0.5598885793871866
PVP01_0733800,59,4,5,68,0.8676470588235294,0.058823529411764705,0.07352941176470588
PVP01_0733900,308,43,139,490,0.6285714285714286,0.08775510204081632,0.2836734693877551
PVP01_0734000,1473,68,72,1613,0.9132052076875388,0.04215747055176689,0.044637321760694355
PVP01_0948600,2244,34,60,2338,0.9597946963216424,0.01454234388366125,0.02566295979469632
PVP01_0948500,48,1,12,61,0.7868852459016393,0.01639344262295082,0.19672131147540983
PVP01_0948400,221,17,28,266,0.8308270676691729,0.06390977443609022,0.10526315789473684
PVP01_0948300,1626,72,51,1749,0.9296740994854202,0.0411663807890223,0.029159519725557463
PVP01_0948200,205,22,14,241,0.8506224066390041,0.0912863070539419,0.058091286307053944
PVP01_0948100,254,31,36,321,0.7912772585669782,0.09657320872274143,0.11214953271028037
PVP01_0948000,284,8,61,353,0.8045325779036827,0.0226628895184136,0.17280453257790368
PVP01_0947900,2984,75,1041,4100,0.7278048780487805,0.018292682926829267,0.25390243902439025
PVP01_0947800,1262,51,1063,2376,0.5311447811447811,0.021464646464646464,0.4473905723905724
PVP01_0947500,608,12,46,666,0.9129129129129129,0.018018018018018018,0.06906906906906907
PVP01_0947300,9,1,3,13,0.6923076923076923,0.07692307692307693,0.23076923076923078
PVP01_0947200,1970,84,433,2487,0.792119018898271,0.033775633293124246,0.17410534780860473
PVP01_0947100,11,0,0,11,1,0,0
PVP01_0946900,29,0,47,76,0.3815789473684211,0,0.618421052631579
PVP01_0946800,102,8,60,170,0.6,0.047058823529411764,0.35294117647058826
PVP01_0946700,236,195,14,445,0.5303370786516854,0.43820224719101125,0.03146067415730337
PVP01_0946600,117,4,4,125,0.936,0.032,0.032
PVP01_0946400,374,23,14,411,0.9099756690997567,0.05596107055961071,0.0340632603406326
PVP01_0946300,584,57,585,1226,0.4763458401305057,0.0464926590538336,0.47716150081566067
PVP01_0946100,2178,158,49,2385,0.9132075471698113,0.06624737945492662,0.020545073375262055
PVP01_0946000,105,7,38,150,0.7,0.04666666666666667,0.25333333333333335
PVP01_0945900,170,24,718,912,0.18640350877192982,0.02631578947368421,0.7872807017543859
PVP01_0945800,313,18,70,401,0.7805486284289277,0.04488778054862843,0.1745635910224439
PVP01_0945700,154,79,1041,1274,0.12087912087912088,0.06200941915227629,0.8171114599686028
PVP01_0945600,213,40,59,312,0.6826923076923077,0.1282051282051282,0.1891025641025641
PVP01_0945400,327,7,9,343,0.9533527696793003,0.02040816326530612,0.026239067055393587
PVP01_0945300,939,237,40,1216,0.772203947368421,0.19490131578947367,0.03289473684210526
PVP01_0945200,2360,108,44,2512,0.9394904458598726,0.042993630573248405,0.01751592356687898
PVP01_0945000,457,132,16,605,0.7553719008264462,0.21818181818181817,0.026446280991735537
PVP01_0944800,784,15,12,811,0.966707768187423,0.018495684340320593,0.014796547472256474
PVP01_0944700,5447,2164,219,7830,0.6956577266922095,0.2763729246487867,0.027969348659003832
PVP01_0944600,189,25,5,219,0.863013698630137,0.1141552511415525,0.0228310502283105
PVP01_0944400,35,1,2,38,0.9210526315789473,0.02631578947368421,0.05263157894736842
PVP01_0944200,78,11,1015,1104,0.07065217391304347,0.009963768115942028,0.9193840579710145
PVP01_0944100,147,62,11,220,0.6681818181818182,0.2818181818181818,0.05
PVP01_0944000,234,102,5,341,0.6862170087976539,0.2991202346041056,0.01466275659824047
PVP01_0943900,3490,320,146,3956,0.8822042467138523,0.08088978766430738,0.036905965621840245
PVP01_0943700,48,1,0,49,0.9795918367346939,0.02040816326530612,0
PVP01_0943600,20,1,258,279,0.07168458781362007,0.0035842293906810036,0.9247311827956989
PVP01_0943500,1459,124,67,1650,0.8842424242424243,0.07515151515151515,0.040606060606060604
PVP01_0943400,1126,168,61,1355,0.8309963099630996,0.12398523985239852,0.045018450184501846
PVP01_0943300,333,222,39,594,0.5606060606060606,0.37373737373737376,0.06565656565656566
PVP01_0943200,1052,519,51,1622,0.6485819975339088,0.3199753390875462,0.031442663378545004
PVP01_0943100,678,479,126,1283,0.5284489477786438,0.37334372564302415,0.09820732657833203
PVP01_0943000,3195,212,533,3940,0.8109137055837563,0.05380710659898477,0.1352791878172589
PVP01_0942900,8,4,0,12,0.6666666666666666,0.3333333333333333,0
PVP01_1459000,1593,289,108,1990,0.800502512562814,0.14522613065326634,0.054271356783919596
PVP01_0942400,2461,74,165,2700,0.9114814814814814,0.027407407407407408,0.06111111111111111
PVP01_0942300,362,8,30,400,0.905,0.02,0.075
PVP01_0942200,71,14,17,102,0.696078431372549,0.13725490196078433,0.16666666666666666
PVP01_0942100,58,1,2,61,0.9508196721311475,0.01639344262295082,0.03278688524590164
PVP01_0942000,1218,21,74,1313,0.9276466108149276,0.015993907083015995,0.05635948210205636
PVP01_0941900,45,3,4,52,0.8653846153846154,0.057692307692307696,0.07692307692307693
PVP01_0941600,298,16,94,408,0.7303921568627451,0.0392156862745098,0.23039215686274508
PVP01_0941500,815,267,35,1117,0.729632945389436,0.23903312444046554,0.03133393017009848
PVP01_0941200,116,3,5,124,0.9354838709677419,0.024193548387096774,0.04032258064516129
PVP01_0941100,15,0,76,91,0.16483516483516483,0,0.8351648351648352
PVP01_0941000,347,7,25,379,0.9155672823218998,0.018469656992084433,0.06596306068601583
PVP01_0940800,12,6,1,19,0.631578947368421,0.3157894736842105,0.05263157894736842
PVP01_0940600,252,14,10,276,0.9130434782608695,0.050724637681159424,0.036231884057971016
PVP01_0940500,1225,48,57,1330,0.9210526315789473,0.03609022556390978,0.04285714285714286
PVP01_0940400,185,4,10,199,0.9296482412060302,0.020100502512562814,0.05025125628140704
PVP01_0940200,76,1,5,82,0.926829268292683,0.012195121951219513,0.06097560975609756
PVP01_0940000,337,44,2,383,0.8798955613577023,0.11488250652741515,0.005221932114882507
PVP01_0939800,1162,222,54,1438,0.808066759388039,0.15438108484005564,0.037552155771905425
PVP01_0939600,484,61,11,556,0.8705035971223022,0.10971223021582734,0.019784172661870502
PVP01_0939500,2103,171,76,2350,0.8948936170212766,0.07276595744680851,0.03234042553191489
PVP01_0939400,484,14,246,744,0.6505376344086021,0.01881720430107527,0.33064516129032256
PVP01_0939200,0,0,3,3,0,0,1
PVP01_0939100,76,5,13,94,0.8085106382978723,0.05319148936170213,0.13829787234042554
PVP01_0938900,218,11,6,235,0.9276595744680851,0.04680851063829787,0.02553191489361702
PVP01_0938800,89,1,41,131,0.6793893129770993,0.007633587786259542,0.31297709923664124
PVP01_0938700,22,1,2,25,0.88,0.04,0.08
PVP01_0938500,491,23,30,544,0.9025735294117647,0.042279411764705885,0.05514705882352941
PVP01_0938400,183,27,1,211,0.8672985781990521,0.12796208530805686,0.004739336492890996
PVP01_0938300,2094,690,71,2855,0.7334500875656742,0.24168126094570927,0.024868651488616462
PVP01_0938100,48,7,621,676,0.07100591715976332,0.010355029585798817,0.9186390532544378
PVP01_0938000,1104,56,91,1251,0.882494004796163,0.04476418864908074,0.07274180655475619
PVP01_0937800,271,105,4025,4401,0.061576914337650536,0.023858214042263123,0.9145648716200864
PVP01_0937700,627,113,28,768,0.81640625,0.14713541666666666,0.036458333333333336
PVP01_0937600,2174,109,1504,3787,0.5740691840506997,0.02878267758119884,0.3971481383681014
PVP01_0937400,5756,397,664,6817,0.8443596890127623,0.05823676103858002,0.09740354994865777
PVP01_0937300,1198,247,138,1583,0.7567909033480733,0.1560328490208465,0.08717624763108023
PVP01_0937200,4563,796,192,5551,0.8220140515222483,0.14339758602053684,0.034588362457214916
PVP01_0936800,140,12,18,170,0.8235294117647058,0.07058823529411765,0.10588235294117647
PVP01_0936700,37,31,2,70,0.5285714285714286,0.44285714285714284,0.02857142857142857
PVP01_0936600,264,166,20,450,0.5866666666666667,0.3688888888888889,0.044444444444444446
PVP01_0936500,385,12,25,422,0.9123222748815166,0.02843601895734597,0.05924170616113744
PVP01_0936400,243,6,11,260,0.9346153846153846,0.023076923076923078,0.04230769230769231
PVP01_0936100,285,45,69,399,0.7142857142857143,0.11278195488721804,0.17293233082706766
PVP01_0935900,657,1113,64,1834,0.35823336968375136,0.6068702290076335,0.03489640130861505
PVP01_0935800,71,1,7,79,0.8987341772151899,0.012658227848101266,0.08860759493670886
PVP01_0935700,2,2,0,4,0.5,0.5,0
PVP01_0935600,362,42,14,418,0.8660287081339713,0.10047846889952153,0.03349282296650718
PVP01_0935500,670,255,25,950,0.7052631578947368,0.26842105263157895,0.02631578947368421
PVP01_0935300,765,45,489,1299,0.5889145496535797,0.03464203233256351,0.37644341801385683
PVP01_0935200,432,32,62,526,0.8212927756653993,0.060836501901140684,0.11787072243346007
PVP01_0935000,1179,2519,189,3887,0.3033187548237715,0.6480576279907384,0.048623617185490096
PVP01_0934900,391,16,4,411,0.9513381995133819,0.038929440389294405,0.009732360097323601
PVP01_0934800,2989,1182,94,4265,0.700820633059789,0.27713950762016415,0.022039859320046894
PVP01_0934700,545,59,81,685,0.7956204379562044,0.08613138686131387,0.11824817518248175
PVP01_0934600,1069,59,47,1175,0.9097872340425532,0.05021276595744681,0.04
PVP01_0934500,1050,283,32,1365,0.7692307692307693,0.20732600732600734,0.023443223443223443
PVP01_0934400,71,9,5,85,0.8352941176470589,0.10588235294117647,0.058823529411764705
PVP01_0934300,115,11,2,128,0.8984375,0.0859375,0.015625
PVP01_0934200,23,7,5879,5909,0.0038923675748857673,0.0011846336097478423,0.9949229988153664
PVP01_0934100,87,1,195,283,0.30742049469964666,0.0035335689045936395,0.6890459363957597
PVP01_0934000,3484,67,158,3709,0.9393367484497169,0.018064168239417634,0.04259908331086546
PVP01_0933900,1507,1644,358,3509,0.42946708463949845,0.46850954687945284,0.10202336848104873
PVP01_0933700,526,72,14,612,0.8594771241830066,0.11764705882352941,0.02287581699346405
PVP01_0933600,559,13,1308,1880,0.2973404255319149,0.006914893617021276,0.6957446808510638
PVP01_0933400,950,278,34,1262,0.7527733755942948,0.2202852614896989,0.02694136291600634
PVP01_0933300,353,9,75,437,0.8077803203661327,0.020594965675057208,0.17162471395881007
PVP01_0933100,785,12,49,846,0.9278959810874704,0.014184397163120567,0.057919621749408984
PVP01_0933000,1953,238,62,2253,0.8668442077230359,0.10563692853972481,0.027518863737239236
PVP01_0932300,13,0,17,30,0.43333333333333335,0,0.5666666666666667
PVP01_0932200,343,43,161,547,0.6270566727605119,0.07861060329067641,0.2943327239488117
PVP01_0932000,1209,22,301,1532,0.7891644908616188,0.014360313315926894,0.19647519582245432
PVP01_0931900,1324,24,769,2117,0.6254133207368918,0.011336797354747285,0.3632498819083609
PVP01_0931600,18,1,4,23,0.782608695652174,0.043478260869565216,0.17391304347826086
PVP01_0931500,1360,123,98,1581,0.8602150537634409,0.0777988614800759,0.06198608475648324
PVP01_0931400,347,386,26,759,0.45718050065876153,0.5085638998682477,0.034255599472990776
PVP01_0931200,1358,88,50,1496,0.9077540106951871,0.058823529411764705,0.03342245989304813
PVP01_0930800,953,670,36,1659,0.5744424352019288,0.4038577456298975,0.0216998191681736
PVP01_0930700,1138,473,37,1648,0.6905339805825242,0.28701456310679613,0.022451456310679612
PVP01_0930600,103,2,21,126,0.8174603174603174,0.015873015873015872,0.16666666666666666
PVP01_0930500,262,53,196,511,0.512720156555773,0.10371819960861056,0.3835616438356164
PVP01_0930400,63,4,4,71,0.8873239436619719,0.056338028169014086,0.056338028169014086
PVP01_0930300,703,14,206,923,0.761646803900325,0.015167930660888408,0.22318526543878656
PVP01_0930200,735,33,9,777,0.9459459459459459,0.04247104247104247,0.011583011583011582
PVP01_0929900,2525,178,39,2742,0.9208606856309264,0.06491611962071481,0.014223194748358862
PVP01_0929800,1504,1985,722,4211,0.35715981952030396,0.47138446924720967,0.17145571123248635
PVP01_0929700,228,98,18,344,0.6627906976744186,0.28488372093023256,0.05232558139534884
PVP01_0929600,321,15,1038,1374,0.2336244541484716,0.010917030567685589,0.7554585152838428
PVP01_0929500,47,0,5,52,0.9038461538461539,0,0.09615384615384616
PVP01_0929400,2279,85,75,2439,0.9343993439934399,0.034850348503485035,0.03075030750307503
PVP01_0929200,275,8,21,304,0.9046052631578947,0.02631578947368421,0.06907894736842106
PVP01_0929100,472,6,10,488,0.9672131147540983,0.012295081967213115,0.020491803278688523
PVP01_0929000,424,69,20,513,0.8265107212475633,0.13450292397660818,0.03898635477582846
PVP01_0928900,1146,74,27,1247,0.9190056134723336,0.05934242181234964,0.02165196471531676
PVP01_0928600,1133,69,4155,5357,0.21149897330595482,0.012880343475826022,0.7756206832182192
PVP01_0928200,1723,176,198,2097,0.8216499761564139,0.08392942298521698,0.0944206008583691
PVP01_0928100,48,12,5,65,0.7384615384615385,0.18461538461538463,0.07692307692307693
PVP01_0928000,149,51,1,201,0.7412935323383084,0.2537313432835821,0.004975124378109453
PVP01_0927900,1,0,1,2,0.5,0,0.5
PVP01_0927800,612,12,13,637,0.9607535321821036,0.018838304552590265,0.02040816326530612
PVP01_0927700,30,119,43,192,0.15625,0.6197916666666666,0.22395833333333334
PVP01_0927600,2215,409,39,2663,0.8317686819376643,0.15358618099887344,0.01464513706346226
PVP01_0927400,1064,30,834,1928,0.5518672199170125,0.015560165975103735,0.43257261410788383
PVP01_0926900,1241,588,45,1874,0.6622198505869797,0.3137673425827108,0.0240128068303095
PVP01_0926800,1063,123,56,1242,0.855877616747182,0.09903381642512077,0.04508856682769726
PVP01_0926700,4120,834,151,5105,0.8070519098922625,0.1633692458374143,0.02957884427032321
PVP01_0926600,958,94,44,1096,0.8740875912408759,0.08576642335766424,0.040145985401459854
PVP01_0926500,886,22,217,1125,0.7875555555555556,0.019555555555555555,0.1928888888888889
PVP01_0926400,14,4,608,626,0.022364217252396165,0.006389776357827476,0.9712460063897763
PVP01_0926300,91,1,17,109,0.8348623853211009,0.009174311926605505,0.1559633027522936
PVP01_0926200,248,44,9,301,0.8239202657807309,0.1461794019933555,0.029900332225913623
PVP01_0926100,1000,482,134,1616,0.6188118811881188,0.29826732673267325,0.08292079207920793
PVP01_0926000,382,121,66,569,0.671353251318102,0.2126537785588752,0.11599297012302284
PVP01_0925900,25,1,3,29,0.8620689655172413,0.034482758620689655,0.10344827586206896
PVP01_0925800,1495,41,26,1562,0.9571062740076824,0.026248399487836107,0.016645326504481434
PVP01_0925700,353,9,12,374,0.9438502673796791,0.02406417112299465,0.03208556149732621
PVP01_0925600,4184,1970,120,6274,0.6668791839336946,0.3139942620337903,0.01912655403251514
PVP01_0925400,978,1499,56,2533,0.3861034346624556,0.5917883932096328,0.022108172127911566
PVP01_0925300,735,199,16,950,0.7736842105263158,0.2094736842105263,0.016842105263157894
PVP01_0925200,1735,103,482,2320,0.7478448275862069,0.04439655172413793,0.20775862068965517
PVP01_0925100,266,24,5,295,0.9016949152542373,0.08135593220338982,0.01694915254237288
PVP01_0925000,146,20,7,173,0.8439306358381503,0.11560693641618497,0.04046242774566474
PVP01_0924900,59,46,3,108,0.5462962962962963,0.42592592592592593,0.027777777777777776
PVP01_0924800,855,22,201,1078,0.7931354359925789,0.02040816326530612,0.18645640074211503
PVP01_0924700,531,60,48,639,0.8309859154929577,0.09389671361502347,0.07511737089201878
PVP01_0924600,583,32,120,735,0.7931972789115647,0.04353741496598639,0.16326530612244897
PVP01_0924500,47,43,2,92,0.5108695652173914,0.4673913043478261,0.021739130434782608
PVP01_0924400,1745,32,296,2073,0.8417752050168837,0.015436565364206465,0.1427882296189098
PVP01_0924300,22,1,1,24,0.9166666666666666,0.041666666666666664,0.041666666666666664
PVP01_0924200,1434,165,172,1771,0.8097120271033315,0.09316770186335403,0.09712027103331451
PVP01_0924100,1759,446,144,2349,0.7488292890591741,0.18986802894848873,0.06130268199233716
PVP01_0924000,5147,1765,130,7042,0.7309003124112468,0.25063902300482815,0.01846066458392502
PVP01_0923900,1488,292,275,2055,0.724087591240876,0.14209245742092458,0.13381995133819952
PVP01_0923800,877,14,18,909,0.9647964796479648,0.015401540154015401,0.019801980198019802
PVP01_0923700,696,396,43,1135,0.613215859030837,0.34889867841409694,0.03788546255506608
PVP01_0923400,1073,46,174,1293,0.8298530549110595,0.03557617942768755,0.1345707656612529
PVP01_0923300,953,4,222,1179,0.8083121289228159,0.0033927056827820186,0.18829516539440203
PVP01_0923200,109,4,259,372,0.29301075268817206,0.010752688172043012,0.696236559139785
PVP01_0923100,324,6,43,373,0.868632707774799,0.0160857908847185,0.11528150134048257
PVP01_0923000,2433,249,67,2749,0.8850491087668243,0.0905783921425973,0.02437249909057839
PVP01_0922900,145,19,10,174,0.8333333333333334,0.10919540229885058,0.05747126436781609
PVP01_0922800,310,84,16,410,0.7560975609756098,0.2048780487804878,0.03902439024390244
PVP01_0922700,285,10,12,307,0.9283387622149837,0.03257328990228013,0.03908794788273615
PVP01_0922600,856,113,21,990,0.8646464646464647,0.11414141414141414,0.021212121212121213
PVP01_0922500,689,11,15,715,0.9636363636363636,0.015384615384615385,0.02097902097902098
PVP01_0922400,61,9,5,75,0.8133333333333334,0.12,0.06666666666666667
PVP01_0922300,1330,104,60,1494,0.8902275769745649,0.06961178045515395,0.040160642570281124
PVP01_0922100,549,37,17,603,0.9104477611940298,0.06135986733001658,0.028192371475953566
PVP01_0922000,279,7,182,468,0.5961538461538461,0.014957264957264958,0.3888888888888889
PVP01_0921900,242,6,8,256,0.9453125,0.0234375,0.03125
PVP01_0921600,55,3,563,621,0.08856682769726248,0.004830917874396135,0.9066022544283414
PVP01_0921500,26,0,1,27,0.9629629629629629,0,0.037037037037037035
PVP01_0921400,456,25,24,505,0.902970297029703,0.04950495049504951,0.047524752475247525
PVP01_0921100,1771,536,38,2345,0.755223880597015,0.22857142857142856,0.0162046908315565
PVP01_0920800,12,8,10,30,0.4,0.26666666666666666,0.3333333333333333
PVP01_0920700,682,160,17,859,0.7939464493597206,0.18626309662398138,0.01979045401629802
PVP01_0920600,2860,2325,132,5317,0.5378973105134475,0.4372766597705473,0.024826029716005265
PVP01_0920100,175,13,5,193,0.9067357512953368,0.06735751295336788,0.025906735751295335
PVP01_0920000,537,35,54,626,0.8578274760383386,0.05591054313099041,0.08626198083067092
PVP01_0919900,1533,377,45,1955,0.7841432225063939,0.19283887468030692,0.023017902813299233
PVP01_0919800,175,46,113,334,0.5239520958083832,0.1377245508982036,0.3383233532934132
PVP01_0919700,362,235,256,853,0.4243845252051583,0.27549824150058616,0.30011723329425555
PVP01_0919600,110,3,23,136,0.8088235294117647,0.022058823529411766,0.16911764705882354
PVP01_0919500,41,0,205,246,0.16666666666666666,0,0.8333333333333334
PVP01_0919400,85,11,169,265,0.32075471698113206,0.04150943396226415,0.6377358490566037
PVP01_0919300,233,22,2976,3231,0.07211389662643145,0.006809037449705973,0.9210770659238626
PVP01_0919200,108,10,2,120,0.9,0.08333333333333333,0.016666666666666666
PVP01_0919100,1273,1621,98,2992,0.4254679144385027,0.5417780748663101,0.032754010695187165
PVP01_0919000,486,37,112,635,0.7653543307086614,0.05826771653543307,0.1763779527559055
PVP01_0918900,474,538,30,1042,0.45489443378119004,0.5163147792706334,0.028790786948176585
PVP01_0918800,480,154,19,653,0.7350689127105666,0.23583460949464014,0.02909647779479326
PVP01_0918700,825,54,14,893,0.9238521836506159,0.060470324748040316,0.015677491601343786
PVP01_0918400,1281,27,523,1831,0.699617695248498,0.01474604041507373,0.2856362643364282
PVP01_0918300,2180,657,230,3067,0.7107923051842191,0.21421584610368438,0.0749918487120965
PVP01_0918200,609,25,16,650,0.936923076923077,0.038461538461538464,0.024615384615384615
PVP01_0918100,1262,74,35,1371,0.9204959883296864,0.05397520058351568,0.025528811086797956
PVP01_0918000,72,13,3176,3261,0.02207911683532659,0.003986507206378411,0.973934375958295
PVP01_0917900,165,62,3,230,0.717391304347826,0.26956521739130435,0.013043478260869565
PVP01_0917700,1824,46,67,1937,0.9416623644811565,0.023748064016520392,0.03458957150232318
PVP01_0917600,322,8,13,343,0.9387755102040817,0.023323615160349854,0.037900874635568516
PVP01_0917500,91,1,108,200,0.455,0.005,0.54
PVP01_0917200,653,72,13,738,0.8848238482384824,0.0975609756097561,0.017615176151761516
PVP01_0917000,1057,73,101,1231,0.8586515028432169,0.059301380991064176,0.08204711616571893
PVP01_0916900,911,37,90,1038,0.8776493256262042,0.03564547206165703,0.08670520231213873
PVP01_0916800,257,18,8,283,0.9081272084805654,0.0636042402826855,0.028268551236749116
PVP01_0916700,1500,176,1554,3230,0.46439628482972134,0.05448916408668731,0.48111455108359136
PVP01_0916600,219,10,2375,2604,0.08410138248847926,0.0038402457757296467,0.9120583717357911
PVP01_0916400,2478,83,67,2628,0.9429223744292238,0.031582952815829526,0.025494672754946726
PVP01_0916300,198,45,3,246,0.8048780487804879,0.18292682926829268,0.012195121951219513
PVP01_0915800,123,11,196,330,0.37272727272727274,0.03333333333333333,0.593939393939394
PVP01_0915700,461,22,12,495,0.9313131313131313,0.044444444444444446,0.024242424242424242
PVP01_0915600,549,6,100,655,0.8381679389312977,0.00916030534351145,0.15267175572519084
PVP01_0915400,3153,180,366,3699,0.8523925385239254,0.04866180048661801,0.0989456609894566
PVP01_0915200,1235,50,28,1313,0.9405940594059405,0.03808073115003808,0.021325209444021324
PVP01_0915100,1645,155,32,1832,0.8979257641921398,0.08460698689956332,0.017467248908296942
PVP01_0915000,1436,167,83,1686,0.8517200474495848,0.09905100830367734,0.04922894424673784
PVP01_0914700,165,4,3,172,0.9593023255813954,0.023255813953488372,0.01744186046511628
PVP01_0914600,1849,73,38,1960,0.9433673469387756,0.037244897959183676,0.019387755102040816
PVP01_0914500,529,48,16,593,0.8920741989881956,0.08094435075885328,0.026981450252951095
PVP01_0914300,195,28,15,238,0.819327731092437,0.11764705882352941,0.06302521008403361
PVP01_0914100,1597,24,526,2147,0.743828598043782,0.011178388448998603,0.2449930135072194
PVP01_0913900,155,77,75,307,0.504885993485342,0.250814332247557,0.24429967426710097
PVP01_0913700,178,1,14,193,0.9222797927461139,0.0051813471502590676,0.07253886010362694
PVP01_0913600,60,1,1,62,0.967741935483871,0.016129032258064516,0.016129032258064516
PVP01_0913500,74,5,10,89,0.8314606741573034,0.056179775280898875,0.11235955056179775
PVP01_0913400,444,12,52,508,0.8740157480314961,0.023622047244094488,0.10236220472440945
PVP01_0913300,381,63,13,457,0.8336980306345733,0.13785557986870897,0.028446389496717725
PVP01_0913100,398,35,12,445,0.8943820224719101,0.07865168539325842,0.02696629213483146
PVP01_0913000,49,11,0,60,0.8166666666666667,0.18333333333333332,0
PVP01_0912900,1955,103,382,2440,0.8012295081967213,0.04221311475409836,0.15655737704918032
PVP01_0912800,38,6,37,81,0.4691358024691358,0.07407407407407407,0.4567901234567901
PVP01_0912700,69,0,126,195,0.35384615384615387,0,0.6461538461538462
PVP01_0912600,813,23,226,1062,0.7655367231638418,0.021657250470809793,0.2128060263653484
PVP01_0912400,176,7,81,264,0.6666666666666666,0.026515151515151516,0.3068181818181818
PVP01_0912300,931,40,27,998,0.9328657314629258,0.04008016032064128,0.027054108216432865
PVP01_0912200,513,25,12,550,0.9327272727272727,0.045454545454545456,0.02181818181818182
PVP01_0912100,522,217,100,839,0.6221692491060786,0.2586412395709178,0.11918951132300358
PVP01_0912000,2901,220,157,3278,0.8849908480780964,0.06711409395973154,0.047895057962172055
PVP01_0911900,194,0,19,213,0.9107981220657277,0,0.0892018779342723
PVP01_0911800,108,189,15,312,0.34615384615384615,0.6057692307692307,0.04807692307692308
PVP01_0911700,313,169,44,526,0.5950570342205324,0.32129277566539927,0.08365019011406843
PVP01_0911600,47,14,1,62,0.7580645161290323,0.22580645161290322,0.016129032258064516
PVP01_0911500,116,1,11,128,0.90625,0.0078125,0.0859375
PVP01_0911400,473,20,36,529,0.8941398865784499,0.03780718336483932,0.06805293005671077
PVP01_0911300,1610,58,232,1900,0.8473684210526315,0.030526315789473683,0.12210526315789473
PVP01_0911100,514,534,93,1141,0.4504820333041192,0.4680105170902717,0.08150744960560911
PVP01_0911000,1823,427,149,2399,0.759899958315965,0.17799082951229678,0.062109212171738225
PVP01_0910900,2146,91,296,2533,0.8472167390446111,0.0359257797078563,0.11685748124753258
PVP01_0910800,10,1,0,11,0.9090909090909091,0.09090909090909091,0
PVP01_0910700,3037,1596,97,4730,0.6420718816067653,0.33742071881606767,0.020507399577167018
PVP01_0910200,181,458,28,667,0.27136431784107945,0.6866566716641679,0.041979010494752625
PVP01_0910000,171,7,749,927,0.18446601941747573,0.007551240560949299,0.807982740021575
PVP01_0909900,151,16,21,188,0.8031914893617021,0.0851063829787234,0.11170212765957446
PVP01_0909700,360,163,7,530,0.6792452830188679,0.30754716981132074,0.013207547169811321
PVP01_0909600,30,2,29,61,0.4918032786885246,0.03278688524590164,0.47540983606557374
PVP01_0909500,811,65,84,960,0.8447916666666667,0.06770833333333333,0.0875
PVP01_0909400,4606,150,82,4838,0.9520463001240181,0.03100454733360893,0.01694915254237288
PVP01_0909300,2166,58,120,2344,0.924061433447099,0.024744027303754267,0.051194539249146756
PVP01_0909200,1650,355,35,2040,0.8088235294117647,0.17401960784313725,0.01715686274509804
PVP01_0909000,589,31,66,686,0.858600583090379,0.04518950437317784,0.09620991253644315
PVP01_0908800,1302,453,1230,2985,0.43618090452261304,0.15175879396984926,0.4120603015075377
PVP01_0908700,142,30,40,212,0.6698113207547169,0.14150943396226415,0.18867924528301888
PVP01_0908500,450,785,24,1259,0.3574265289912629,0.6235107227958697,0.019062748212867357
PVP01_0908400,271,17,19,307,0.8827361563517915,0.05537459283387622,0.06188925081433225
PVP01_0908300,151,13,15,179,0.8435754189944135,0.07262569832402235,0.08379888268156424
PVP01_0908000,1462,96,29,1587,0.9212350346565847,0.06049149338374291,0.018273471959672338
PVP01_0907800,21,6,2,29,0.7241379310344828,0.20689655172413793,0.06896551724137931
PVP01_0907700,136,3,2,141,0.9645390070921985,0.02127659574468085,0.014184397163120567
PVP01_0907500,2293,130,357,2780,0.8248201438848921,0.046762589928057555,0.12841726618705035
PVP01_0907400,557,70,17,644,0.8649068322981367,0.10869565217391304,0.026397515527950312
PVP01_0907300,574,99,14,687,0.8355167394468704,0.14410480349344978,0.020378457059679767
PVP01_0907200,55,8,4,67,0.8208955223880597,0.11940298507462686,0.05970149253731343
PVP01_0907100,1013,73,27,1113,0.9101527403414196,0.06558849955076371,0.02425876010781671
PVP01_0907000,1596,504,61,2161,0.7385469689958353,0.23322535863026378,0.02822767237390097
PVP01_0906900,1349,60,32,1441,0.9361554476058292,0.041637751561415685,0.02220680083275503
PVP01_0906800,644,109,21,774,0.8320413436692506,0.14082687338501293,0.027131782945736434
PVP01_0906700,1,0,0,1,1,0,0
PVP01_0906600,528,113,60,701,0.7532097004279601,0.16119828815977175,0.08559201141226819
PVP01_0906400,1354,1094,1363,3811,0.3552873261611126,0.28706376279191814,0.3576489110469693
PVP01_0906300,522,13,29,564,0.925531914893617,0.02304964539007092,0.051418439716312055
PVP01_0906200,2872,1077,97,4046,0.7098368759268413,0.2661888284725655,0.02397429560059318
PVP01_0906100,1862,177,757,2796,0.6659513590844063,0.06330472103004292,0.2707439198855508
PVP01_0906000,41,0,38,79,0.5189873417721519,0,0.4810126582278481
PVP01_0905800,38941,1411,54851,95203,0.4090312280075208,0.014820961524321713,0.5761478104681576
PVP01_0905700,453,18,735,1206,0.3756218905472637,0.014925373134328358,0.6094527363184079
PVP01_0905600,20,6,1,27,0.7407407407407407,0.2222222222222222,0.037037037037037035
PVP01_0905500,695,63,16,774,0.8979328165374677,0.08139534883720931,0.020671834625323
PVP01_0905400,69,0,19,88,0.7840909090909091,0,0.2159090909090909
PVP01_0905300,60,0,17,77,0.7792207792207793,0,0.22077922077922077
PVP01_0905200,2466,356,54,2876,0.8574408901251739,0.12378303198887343,0.018776077885952713
PVP01_0905100,1536,271,43,1850,0.8302702702702702,0.1464864864864865,0.023243243243243242
PVP01_0905000,4266,258,689,5213,0.8183387684634568,0.04949165547669288,0.13216957605985039
PVP01_0904900,954,350,108,1412,0.6756373937677054,0.24787535410764872,0.0764872521246459
PVP01_0904800,988,458,38,1484,0.6657681940700808,0.3086253369272237,0.025606469002695417
PVP01_0904700,4,0,0,4,1,0,0
PVP01_0904400,267,18,6,291,0.9175257731958762,0.061855670103092786,0.020618556701030927
PVP01_0904300,255,35,21,311,0.819935691318328,0.11254019292604502,0.06752411575562701
PVP01_0904200,646,154,41,841,0.7681331747919143,0.18311533888228299,0.04875148632580262
PVP01_0903900,1948,1002,61,3011,0.6469611424775822,0.3327798073729658,0.02025905014945201
PVP01_0302300,960,75,32,1067,0.8997188378631678,0.07029053420805999,0.02999062792877226
PVP01_0302500,583,29,34,646,0.9024767801857585,0.04489164086687306,0.05263157894736842
PVP01_0302700,172,9,5,186,0.9247311827956989,0.04838709677419355,0.026881720430107527
PVP01_0303000,1877,290,157,2324,0.8076592082616179,0.12478485370051635,0.06755593803786575
PVP01_0303300,12,0,359,371,0.03234501347708895,0,0.967654986522911
PVP01_0303500,100,14,3,117,0.8547008547008547,0.11965811965811966,0.02564102564102564
PVP01_0304100,117,49,8159,8325,0.014054054054054054,0.005885885885885886,0.9800600600600601
PVP01_0304200,192,1,148,341,0.5630498533724341,0.002932551319648094,0.4340175953079179
PVP01_0304400,377,445,52,874,0.43135011441647597,0.5091533180778032,0.059496567505720827
PVP01_0304500,196,45,24,265,0.7396226415094339,0.16981132075471697,0.09056603773584905
PVP01_0304800,1741,436,248,2425,0.7179381443298969,0.1797938144329897,0.1022680412371134
PVP01_0304900,8,6,1,15,0.5333333333333333,0.4,0.06666666666666667
PVP01_0305000,165,53,11,229,0.7205240174672489,0.2314410480349345,0.048034934497816595
PVP01_0305100,113,8,21,142,0.795774647887324,0.056338028169014086,0.14788732394366197
PVP01_0305200,140,14,7,161,0.8695652173913043,0.08695652173913043,0.043478260869565216
PVP01_0305400,2787,1710,2659,7156,0.3894633873672443,0.23896031302403578,0.37157629960871996
PVP01_0305500,306,45,14,365,0.8383561643835616,0.1232876712328767,0.038356164383561646
PVP01_0305700,1073,277,24,1374,0.7809315866084425,0.20160116448326054,0.017467248908296942
PVP01_0305900,89,2,1,92,0.967391304347826,0.021739130434782608,0.010869565217391304
PVP01_0306000,596,42,161,799,0.7459324155193993,0.052565707133917394,0.20150187734668334
PVP01_0306100,443,18,5,466,0.9506437768240343,0.03862660944206009,0.01072961373390558
PVP01_0306400,1168,63,367,1598,0.7309136420525657,0.039424280350438046,0.22966207759699625
PVP01_0306500,1854,276,129,2259,0.8207171314741036,0.12217795484727756,0.057104913678618856
PVP01_0306600,1021,465,143,1629,0.6267648864333947,0.285451197053407,0.08778391651319828
PVP01_0306700,390,269,18,677,0.5760709010339734,0.397341211225997,0.026587887740029542
PVP01_0306800,236,180,11,427,0.5526932084309133,0.4215456674473068,0.02576112412177986
PVP01_0307000,2509,119,476,3104,0.8083118556701031,0.038337628865979384,0.15335051546391754
PVP01_0307100,847,27,702,1576,0.5374365482233503,0.01713197969543147,0.44543147208121825
PVP01_0307200,1567,76,188,1831,0.855816493719279,0.04150737302020754,0.10267613326051338
PVP01_0307300,9,2,12,23,0.391304347826087,0.08695652173913043,0.5217391304347826
PVP01_0307500,33,11,11,55,0.6,0.2,0.2
PVP01_0307600,1091,387,214,1692,0.6447990543735225,0.22872340425531915,0.12647754137115838
PVP01_0307700,838,83,23,944,0.8877118644067796,0.08792372881355932,0.024364406779661018
PVP01_0307800,2343,39,210,2592,0.9039351851851852,0.015046296296296295,0.08101851851851852
PVP01_0308300,778,68,78,924,0.841991341991342,0.0735930735930736,0.08441558441558442
PVP01_0308400,273,198,46,517,0.528046421663443,0.3829787234042553,0.08897485493230174
PVP01_0308500,622,894,114,1630,0.3815950920245399,0.5484662576687117,0.06993865030674846
PVP01_0308700,349,176,15,540,0.6462962962962963,0.32592592592592595,0.027777777777777776
PVP01_0308800,1463,162,45,1670,0.8760479041916168,0.09700598802395209,0.02694610778443114
PVP01_0308900,1359,37,157,1553,0.8750804893754024,0.023824855119124275,0.10109465550547328
PVP01_0309000,557,32,18,607,0.9176276771004942,0.05271828665568369,0.029654036243822075
PVP01_0309100,2048,2263,2927,7238,0.28295109146172975,0.3126554296767063,0.40439347886156396
PVP01_0309200,3,5,1,9,0.3333333333333333,0.5555555555555556,0.1111111111111111
PVP01_0309700,193,33,4,230,0.8391304347826087,0.14347826086956522,0.017391304347826087
PVP01_0309800,117,7,10,134,0.8731343283582089,0.05223880597014925,0.07462686567164178
PVP01_0309900,83,29,8,120,0.6916666666666667,0.24166666666666667,0.06666666666666667
PVP01_1312900,499,9,23,531,0.9397363465160076,0.01694915254237288,0.04331450094161959
PVP01_1313100,753,85,18,856,0.8796728971962616,0.09929906542056074,0.02102803738317757
PVP01_1313400,1900,26,355,2281,0.8329679964927663,0.011398509425690487,0.15563349408154317
PVP01_1313500,1378,129,45,1552,0.8878865979381443,0.08311855670103092,0.028994845360824743
PVP01_1313600,307,6,14,327,0.9388379204892966,0.01834862385321101,0.04281345565749235
PVP01_1313700,103,22,2,127,0.8110236220472441,0.1732283464566929,0.015748031496062992
PVP01_1314000,1345,269,57,1671,0.8049072411729503,0.16098144823459007,0.03411131059245961
PVP01_1314100,9,1,1,11,0.8181818181818182,0.09090909090909091,0.09090909090909091
PVP01_1314400,191,4,5,200,0.955,0.02,0.025
PVP01_1314500,208,7,15,230,0.9043478260869565,0.030434782608695653,0.06521739130434782
PVP01_1314600,16,2,8,26,0.6153846153846154,0.07692307692307693,0.3076923076923077
PVP01_1314700,760,137,15,912,0.8333333333333334,0.15021929824561403,0.01644736842105263
PVP01_1314800,58,8,1,67,0.8656716417910447,0.11940298507462686,0.014925373134328358
PVP01_1314900,1531,852,54,2437,0.6282314320886335,0.34961017644645054,0.02215839146491588
PVP01_1315100,15,3,283,301,0.04983388704318937,0.009966777408637873,0.9401993355481728
PVP01_1315200,1247,614,70,1931,0.6457793889176593,0.31796996374935266,0.03625064733298809
PVP01_1315300,8095,329,419,8843,0.9154133212710619,0.03720456858532172,0.04738211014361642
PVP01_1315400,652,621,32,1305,0.49961685823754787,0.47586206896551725,0.024521072796934867
PVP01_1315500,1037,313,28,1378,0.7525399129172714,0.22714078374455732,0.020319303338171262
PVP01_1315800,719,32,816,1567,0.4588385449904276,0.0204211869814933,0.5207402680280792
PVP01_1315900,517,48,17,582,0.8883161512027491,0.08247422680412371,0.029209621993127148
PVP01_1316300,378,13,116,507,0.7455621301775148,0.02564102564102564,0.22879684418145957
PVP01_1316500,2,0,0,2,1,0,0
PVP01_1316600,290,23,631,944,0.3072033898305085,0.024364406779661018,0.6684322033898306
PVP01_1316800,718,31,97,846,0.8486997635933806,0.03664302600472813,0.11465721040189125
PVP01_1316900,1216,99,353,1668,0.7290167865707434,0.05935251798561151,0.21163069544364507
PVP01_1317000,245,676,287,1208,0.20281456953642385,0.5596026490066225,0.23758278145695363
PVP01_1317100,834,34,99,967,0.8624612202688728,0.03516028955532575,0.10237849017580145
PVP01_1317200,187,11,21,219,0.8538812785388128,0.0502283105022831,0.0958904109589041
PVP01_1317300,315,12,67,394,0.799492385786802,0.030456852791878174,0.1700507614213198
PVP01_1317400,1254,175,23,1452,0.8636363636363636,0.12052341597796143,0.01584022038567493
PVP01_1317600,73,12,6,91,0.8021978021978022,0.13186813186813187,0.06593406593406594
PVP01_1317700,6028,2425,246,8699,0.69295321301299,0.27876767444533856,0.028279112541671456
PVP01_1317800,912,19,16,947,0.9630411826821542,0.02006335797254488,0.01689545934530095
PVP01_1317900,479,8,21,508,0.9429133858267716,0.015748031496062992,0.04133858267716536
PVP01_1318100,1674,802,168,2644,0.6331316187594553,0.3033282904689864,0.06354009077155824
PVP01_1318300,203,8,33,244,0.8319672131147541,0.03278688524590164,0.13524590163934427
PVP01_1318500,60,5,15,80,0.75,0.0625,0.1875
PVP01_1318600,48,5,567,620,0.07741935483870968,0.008064516129032258,0.9145161290322581
PVP01_1318800,551,11,66,628,0.8773885350318471,0.01751592356687898,0.10509554140127389
PVP01_1318900,37,1,0,38,0.9736842105263158,0.02631578947368421,0
PVP01_1319000,3297,263,356,3916,0.8419305413687436,0.06716036772216548,0.09090909090909091
PVP01_1319100,832,76,50,958,0.8684759916492694,0.07933194154488518,0.05219206680584551
PVP01_1319300,107,2,8,117,0.9145299145299145,0.017094017094017096,0.06837606837606838
PVP01_1319400,82,6,10,98,0.8367346938775511,0.061224489795918366,0.10204081632653061
PVP01_1319500,498,12,76,586,0.8498293515358362,0.020477815699658702,0.1296928327645051
PVP01_1319600,631,58,46,735,0.8585034013605443,0.07891156462585033,0.06258503401360545
PVP01_1319800,712,23,111,846,0.8416075650118203,0.027186761229314422,0.13120567375886524
PVP01_1319900,1068,496,273,1837,0.5813826891671203,0.2700054436581383,0.14861186717474142
PVP01_1320000,1976,126,260,2362,0.8365791701947503,0.05334462320067739,0.1100762066045724
PVP01_1320100,198,13,104,315,0.6285714285714286,0.04126984126984127,0.33015873015873015
PVP01_1320400,24,5,1,30,0.8,0.16666666666666666,0.03333333333333333
PVP01_1320500,2764,55,64,2883,0.9587235518557059,0.019077349982656956,0.022199098161637183
PVP01_1320600,617,61,601,1279,0.48240813135261923,0.04769351055512119,0.4698983580922596
PVP01_1320700,407,89,410,906,0.4492273730684327,0.09823399558498896,0.45253863134657835
PVP01_1320900,416,35,315,766,0.5430809399477807,0.04569190600522193,0.4112271540469974
PVP01_1321000,3146,727,828,4701,0.6692193150393533,0.15464794724526695,0.1761327377153797
PVP01_1321100,144,19,132,295,0.488135593220339,0.06440677966101695,0.44745762711864406
PVP01_1321300,126,2,0,128,0.984375,0.015625,0
PVP01_1321500,1589,290,45,1924,0.8258835758835759,0.15072765072765074,0.02338877338877339
PVP01_1321600,39,0,7,46,0.8478260869565217,0,0.15217391304347827
PVP01_1321900,121,8,10,139,0.8705035971223022,0.05755395683453238,0.07194244604316546
PVP01_1322000,2299,45,145,2489,0.9236641221374046,0.01807955002008839,0.05825632784250703
PVP01_1322100,167,8,184,359,0.46518105849582175,0.022284122562674095,0.5125348189415042
PVP01_1322200,29,3,5,37,0.7837837837837838,0.08108108108108109,0.13513513513513514
PVP01_1322300,421,22,51,494,0.8522267206477733,0.044534412955465584,0.10323886639676114
PVP01_1322400,1367,33,246,1646,0.830498177399757,0.020048602673147023,0.14945321992709598
PVP01_1322600,431,273,23,727,0.5928473177441541,0.37551581843191195,0.03163686382393398
PVP01_1322900,1,0,0,1,1,0,0
PVP01_1323000,5,0,0,5,1,0,0
PVP01_1323100,499,216,25,740,0.6743243243243243,0.2918918918918919,0.033783783783783786
PVP01_1323200,3797,2249,743,6789,0.5592870820444837,0.33127117395787303,0.10944174399764324
PVP01_1323300,11391,6941,1041,19373,0.5879832756929747,0.3582821452537036,0.053734579053321636
PVP01_1323400,353,100,8,461,0.7657266811279827,0.21691973969631237,0.01735357917570499
PVP01_1323600,1160,102,391,1653,0.7017543859649122,0.06170598911070781,0.2365396249243799
PVP01_1323800,5,0,1,6,0.8333333333333334,0,0.16666666666666666
PVP01_1323900,848,16,119,983,0.8626653102746694,0.01627670396744659,0.12105798575788403
PVP01_1324000,953,31,227,1211,0.786952931461602,0.02559867877786953,0.1874483897605285
PVP01_1324100,339,9,3,351,0.9658119658119658,0.02564102564102564,0.008547008547008548
PVP01_1324700,2437,1518,305,4260,0.5720657276995306,0.3563380281690141,0.0715962441314554
PVP01_1324800,5258,3660,163,9081,0.5790111221231142,0.4030393128510076,0.017949565025878206
PVP01_1325200,895,185,272,1352,0.6619822485207101,0.13683431952662722,0.20118343195266272
PVP01_1325400,93,2,64,159,0.5849056603773585,0.012578616352201259,0.4025157232704403
PVP01_1325700,611,9,183,803,0.7608966376089664,0.0112079701120797,0.22789539227895392
PVP01_1325800,2242,61,66,2369,0.9463908822287885,0.025749261291684256,0.027859856479527226
PVP01_1326000,880,1195,101,2176,0.40441176470588236,0.5491727941176471,0.04641544117647059
PVP01_1326100,207,16,10,233,0.8884120171673819,0.06866952789699571,0.04291845493562232
PVP01_1326200,351,27,8,386,0.9093264248704663,0.06994818652849741,0.02072538860103627
PVP01_1326400,597,5,95,697,0.8565279770444764,0.007173601147776184,0.13629842180774748
PVP01_1326500,260,37,72,369,0.7046070460704607,0.1002710027100271,0.1951219512195122
PVP01_1326600,583,476,44,1103,0.528558476881233,0.4315503173164098,0.03989120580235721
PVP01_1326800,37,2,981,1020,0.03627450980392157,0.00196078431372549,0.961764705882353
PVP01_1327000,385,16,33,434,0.8870967741935484,0.03686635944700461,0.07603686635944701
PVP01_1327100,6090,241,529,6860,0.8877551020408163,0.03513119533527697,0.07711370262390671
PVP01_1327300,167,35,11,213,0.784037558685446,0.1643192488262911,0.051643192488262914
PVP01_1327500,89,26,7,122,0.7295081967213115,0.21311475409836064,0.05737704918032787
PVP01_1327700,2268,889,59,3216,0.7052238805970149,0.2764303482587065,0.018345771144278607
PVP01_1327800,240,116,92,448,0.5357142857142857,0.25892857142857145,0.20535714285714285
PVP01_1327900,982,215,150,1347,0.7290274684484038,0.15961395694135114,0.111358574610245
PVP01_1328000,924,22,317,1263,0.7315914489311164,0.01741884402216944,0.2509897070467142
PVP01_1328200,211,240,221,672,0.31398809523809523,0.35714285714285715,0.3288690476190476
PVP01_1328300,267,110,1371,1748,0.15274599542334097,0.06292906178489703,0.784324942791762
PVP01_1328400,1103,53,74,1230,0.8967479674796748,0.043089430894308944,0.06016260162601626
PVP01_1328500,4289,535,109,4933,0.8694506385566593,0.10845327386985606,0.022096087573484694
PVP01_1328600,1224,234,455,1913,0.639832723470988,0.12232096184004182,0.23784631468897022
PVP01_1328700,3882,106,793,4781,0.8119640242627065,0.022171093913407238,0.16586488182388623
PVP01_1328800,110,8,25,143,0.7692307692307693,0.055944055944055944,0.17482517482517482
PVP01_1328900,168,28,9,205,0.8195121951219512,0.13658536585365855,0.04390243902439024
PVP01_1329000,352,41,23,416,0.8461538461538461,0.0985576923076923,0.055288461538461536
PVP01_1329100,2230,386,108,2724,0.8186490455212923,0.14170337738619676,0.039647577092511016
PVP01_1329200,4741,2238,177,7156,0.6625209614309671,0.3127445500279486,0.024734488541084405
PVP01_1329300,3228,215,655,4098,0.787701317715959,0.052464616886285995,0.159834065397755
PVP01_1329400,648,11,47,706,0.9178470254957507,0.015580736543909348,0.06657223796033994
PVP01_1329600,174,15,2,191,0.9109947643979057,0.078534031413612565,0.010471204188481676
PVP01_1329700,106,19,1,126,0.8412698412698413,0.15079365079365079,0.007936507936507936
PVP01_1329800,883,1472,275,2630,0.33574144486692015,0.5596958174904944,0.10456273764258556
PVP01_1330000,1355,2057,66,3478,0.3895917193789534,0.5914318573893041,0.01897642323174238
PVP01_1330600,39,0,7,46,0.8478260869565217,0,0.15217391304347827
PVP01_1330700,185,5,5,195,0.9487179487179487,0.02564102564102564,0.02564102564102564
PVP01_1330800,48,1,0,49,0.9795918367346939,0.02040816326530612,0
PVP01_1330900,1445,101,290,1836,0.7870370370370371,0.05501089324618736,0.1579520697167756
PVP01_1331000,1844,59,95,1998,0.9229229229229229,0.02952952952952953,0.047547547547547545
PVP01_1331100,1933,30,50,2013,0.9602583209140586,0.014903129657228018,0.024838549428713365
PVP01_1331200,2198,37,95,2330,0.9433476394849786,0.01587982832618026,0.0407725321888412
PVP01_1331600,545,3,229,777,0.7014157014157014,0.003861003861003861,0.2947232947232947
PVP01_1331800,57,1,2,60,0.95,0.016666666666666666,0.03333333333333333
PVP01_1331900,7,3,33,43,0.16279069767441862,0.06976744186046512,0.7674418604651163
PVP01_1332000,456,85,17,558,0.8172043010752689,0.15232974910394265,0.03046594982078853
PVP01_1332100,835,27,25,887,0.9413754227733935,0.030439684329199548,0.02818489289740699
PVP01_1332200,183,2,12,197,0.9289340101522843,0.01015228426395939,0.06091370558375635
PVP01_1332500,197,38,64,299,0.6588628762541806,0.12709030100334448,0.2140468227424749
PVP01_1332700,755,11,292,1058,0.7136105860113422,0.010396975425330813,0.27599243856332706
PVP01_1332800,377,98,15,490,0.7693877551020408,0.2,0.030612244897959183
PVP01_1332900,13,4,1,18,0.7222222222222222,0.2222222222222222,0.05555555555555555
PVP01_1333000,188,18,6,212,0.8867924528301887,0.08490566037735849,0.02830188679245283
PVP01_1333200,537,28,279,844,0.6362559241706162,0.03317535545023697,0.3305687203791469
PVP01_1333400,261,19,156,436,0.5986238532110092,0.04357798165137615,0.3577981651376147
PVP01_1333600,77,3,2,82,0.9390243902439024,0.036585365853658534,0.024390243902439025
PVP01_1333700,155,74,12,241,0.6431535269709544,0.3070539419087137,0.04979253112033195
PVP01_1333800,8,2,228,238,0.03361344537815126,0.008403361344537815,0.957983193277311
PVP01_1333900,346,7,113,466,0.7424892703862661,0.015021459227467811,0.24248927038626608
PVP01_1334000,623,82,226,931,0.6691729323308271,0.08807733619763695,0.24274973147153597
PVP01_1334100,151,33,13,197,0.766497461928934,0.16751269035532995,0.06598984771573604
PVP01_1334300,1616,465,172,2253,0.717265867731913,0.20639147802929428,0.07634265423879272
PVP01_1334400,696,75,296,1067,0.6522961574507966,0.07029053420805999,0.2774133083411434
PVP01_1334500,52,4,4,60,0.8666666666666667,0.06666666666666667,0.06666666666666667
PVP01_1334600,1955,992,65,3012,0.649070385126162,0.3293492695883134,0.02158034528552457
PVP01_1334700,425,356,118,899,0.4727474972191324,0.39599555061179087,0.13125695216907676
PVP01_1334800,52,9,7,68,0.7647058823529411,0.1323529411764706,0.10294117647058823
PVP01_1334900,1204,48,86,1338,0.8998505231689088,0.03587443946188341,0.06427503736920777
PVP01_1335000,76,10,13,99,0.7676767676767676,0.10101010101010101,0.13131313131313133
PVP01_1335100,310,250,183,743,0.41722745625841184,0.3364737550471063,0.24629878869448182
PVP01_1335400,406,27,16,449,0.9042316258351893,0.060133630289532294,0.035634743875278395
PVP01_1335500,2954,130,75,3159,0.9351060462171573,0.0411522633744856,0.023741690408357077
PVP01_1335800,19,7,2,28,0.6785714285714286,0.25,0.07142857142857142
PVP01_1336000,242,47,4,293,0.825938566552901,0.16040955631399317,0.013651877133105802
PVP01_1336100,193,12,3,208,0.9278846153846154,0.057692307692307696,0.014423076923076924
PVP01_1336300,916,478,32,1426,0.6423562412342216,0.33520336605890605,0.02244039270687237
PVP01_1336600,1952,311,36,2299,0.8490648107872988,0.13527620704654197,0.0156589821661592
PVP01_1336700,165,5,9,179,0.9217877094972067,0.027932960893854747,0.05027932960893855
PVP01_1336800,1075,28,17,1120,0.9598214285714286,0.025,0.015178571428571428
PVP01_1337100,1109,486,242,1837,0.6037016875340229,0.26456178551986936,0.1317365269461078
PVP01_1337200,63,82,1,146,0.4315068493150685,0.5616438356164384,0.00684931506849315
PVP01_1337400,530,420,68,1018,0.5206286836935167,0.412573673870334,0.06679764243614932
PVP01_1337500,383,38,29,450,0.8511111111111112,0.08444444444444445,0.06444444444444444
PVP01_1337600,611,42,99,752,0.8125,0.05585106382978723,0.13164893617021275
PVP01_1337700,1090,94,319,1503,0.7252162341982701,0.06254158349966733,0.21224218230206254
PVP01_1337800,1,0,0,1,1,0,0
PVP01_1337900,50,0,8,58,0.8620689655172413,0,0.13793103448275862
PVP01_1338000,782,59,548,1389,0.5629949604031678,0.042476601871850254,0.39452843772498203
PVP01_1338200,779,38,44,861,0.9047619047619048,0.04413472706155633,0.05110336817653891
PVP01_1338300,128,48,8,184,0.6956521739130435,0.2608695652173913,0.043478260869565216
PVP01_1338400,193,22,6,221,0.8733031674208145,0.09954751131221719,0.027149321266968326
PVP01_1338500,156,18,8759,8933,0.017463338184260605,0.0020150005597223777,0.980521661256017
PVP01_1338700,166,219,22,407,0.40786240786240785,0.538083538083538,0.05405405405405406
PVP01_1338800,10,1,4,15,0.6666666666666666,0.06666666666666667,0.26666666666666666
PVP01_1338900,1202,155,51,1408,0.8536931818181818,0.11008522727272728,0.03622159090909091
PVP01_1339000,2623,215,128,2966,0.8843560350640594,0.0724881995954147,0.04315576534052596
PVP01_1339100,36,11,1,48,0.75,0.22916666666666666,0.020833333333333332
PVP01_1339200,76,5,8,89,0.8539325842696629,0.056179775280898875,0.0898876404494382
PVP01_1339400,2020,949,675,3644,0.5543358946212953,0.26042810098792535,0.18523600439077936
PVP01_1339600,236,5,554,795,0.2968553459119497,0.006289308176100629,0.6968553459119496
PVP01_1339700,1278,33,74,1385,0.9227436823104693,0.023826714801444042,0.053429602888086646
PVP01_1339800,238,6,97,341,0.6979472140762464,0.017595307917888565,0.2844574780058651
PVP01_1339900,5357,313,203,5873,0.9121403030819002,0.05329473863442874,0.03456495828367104
PVP01_1340000,435,337,40,812,0.5357142857142857,0.41502463054187194,0.04926108374384237
PVP01_1340100,32,31,1,64,0.5,0.484375,0.015625
PVP01_1340200,56,5,7,68,0.8235294117647058,0.07352941176470588,0.10294117647058823
PVP01_1340300,1825,136,78,2039,0.8950465914664051,0.06669936243256498,0.038254046101029913
PVP01_1340400,13679,6088,493,20260,0.6751727541954591,0.30049358341559723,0.02433366238894373
PVP01_1340500,322,478,29,829,0.3884197828709288,0.5765983112183354,0.03498190591073583
PVP01_1340600,399,24,31,454,0.8788546255506607,0.05286343612334802,0.06828193832599119
PVP01_1341000,8,1,0,9,0.8888888888888888,0.1111111111111111,0
PVP01_1341200,277,71,32,380,0.7289473684210527,0.1868421052631579,0.08421052631578947
PVP01_1341300,394,30,39,463,0.8509719222462203,0.06479481641468683,0.08423326133909287
PVP01_1341400,732,286,260,1278,0.5727699530516432,0.2237871674491393,0.20344287949921752
PVP01_1341500,423,109,271,803,0.526774595267746,0.1357409713574097,0.33748443337484435
PVP01_1341600,710,531,91,1332,0.5330330330330331,0.39864864864864863,0.06831831831831832
PVP01_1341700,11,1,4,16,0.6875,0.0625,0.25
PVP01_1341800,315,44,20,379,0.8311345646437994,0.11609498680738786,0.052770448548812667
PVP01_1341900,127,13,502,642,0.19781931464174454,0.020249221183800622,0.7819314641744548
PVP01_1342000,346,14,17,377,0.9177718832891246,0.03713527851458886,0.04509283819628647
PVP01_1342100,1438,300,42,1780,0.8078651685393259,0.16853932584269662,0.02359550561797753
PVP01_1342300,474,12,21,507,0.9349112426035503,0.023668639053254437,0.04142011834319527
PVP01_1342400,2610,2171,147,4928,0.5296266233766234,0.44054383116883117,0.029829545454545456
PVP01_1342500,4599,2685,229,7513,0.612138959137495,0.3573805403966458,0.03048050046585918
PVP01_1342600,277,133,10,420,0.6595238095238095,0.31666666666666665,0.023809523809523808
PVP01_1342700,131,16,3,150,0.8733333333333333,0.10666666666666667,0.02
PVP01_1343000,1148,2336,99,3583,0.3204018978509629,0.6519676248953391,0.027630477253698018
PVP01_1343100,197,351,207,755,0.2609271523178808,0.4649006622516556,0.27417218543046357
PVP01_1343200,1067,21,70,1158,0.9214162348877375,0.018134715025906734,0.06044905008635579
PVP01_1343300,260,31,6,297,0.8754208754208754,0.10437710437710437,0.020202020202020204
PVP01_1343400,791,28,32,851,0.9294947121034077,0.03290246768507638,0.03760282021151586
PVP01_1343500,1669,149,56,1874,0.8906083244397012,0.07950907150480256,0.029882604055496264
PVP01_1343600,454,47,10,511,0.8884540117416829,0.09197651663405088,0.019569471624266144
PVP01_1343800,472,84,10,566,0.833922261484099,0.14840989399293286,0.0176678445229682
PVP01_1343900,635,445,58,1138,0.5579964850615114,0.39103690685413006,0.050966608084358524
PVP01_1344100,43,211,365,619,0.06946688206785137,0.3408723747980614,0.5896607431340872
PVP01_1344200,201,15,20,236,0.8516949152542372,0.0635593220338983,0.0847457627118644
PVP01_1344500,0,0,2,2,0,0,1
PVP01_1344700,544,21,185,750,0.7253333333333334,0.028,0.24666666666666667
PVP01_1344800,202,9,5,216,0.9351851851851852,0.041666666666666664,0.023148148148148147
PVP01_1345200,113,5,39,157,0.7197452229299363,0.03184713375796178,0.2484076433121019
PVP01_1345400,93,3,2,98,0.9489795918367347,0.030612244897959183,0.02040816326530612
PVP01_1345500,31,0,2,33,0.9393939393939394,0,0.06060606060606061
PVP01_1345700,3040,70,181,3291,0.9237313886356731,0.02127013065937405,0.054998480704952904
PVP01_1345800,81,1,1,83,0.9759036144578314,0.012048192771084338,0.012048192771084338
PVP01_1346100,1833,202,194,2229,0.8223418573351279,0.09062359802602064,0.0870345446388515
PVP01_1346200,16255,8701,545,25501,0.6374259832947727,0.3412023057919297,0.021371710913297516
PVP01_1346400,1750,97,83,1930,0.9067357512953368,0.050259067357512954,0.043005181347150256
PVP01_1346500,1773,144,50,1967,0.9013726487036096,0.07320793085917641,0.02541942043721403
PVP01_1346600,523,37,208,768,0.6809895833333334,0.048177083333333336,0.2708333333333333
PVP01_1346700,1016,46,29,1091,0.9312557286892759,0.04216315307057745,0.026581118240146653
PVP01_1346800,391,14,1,406,0.9630541871921182,0.034482758620689655,0.0024630541871921183
PVP01_1346900,585,70,108,763,0.7667103538663171,0.09174311926605505,0.14154652686762778
PVP01_1347000,56,7,10,73,0.7671232876712328,0.0958904109589041,0.136986301369863
PVP01_1033300,108,1,2,111,0.972972972972973,0.009009009009009009,0.018018018018018018
PVP01_1033200,1959,39,36,2034,0.9631268436578171,0.019174041297935103,0.017699115044247787
PVP01_1033100,388,29,6,423,0.91725768321513,0.06855791962174941,0.014184397163120567
PVP01_1033000,317,59,15,391,0.8107416879795396,0.15089514066496162,0.03836317135549872
PVP01_1032900,319,37,20,376,0.848404255319149,0.09840425531914894,0.05319148936170213
PVP01_1032800,616,413,25,1054,0.5844402277039848,0.3918406072106262,0.023719165085388995
PVP01_1032600,829,1005,74,1908,0.43448637316561844,0.5267295597484277,0.03878406708595388
PVP01_1032400,239,21,24,284,0.8415492957746479,0.07394366197183098,0.08450704225352113
PVP01_1032300,1324,98,39,1461,0.9062286105407256,0.06707734428473648,0.026694045174537988
PVP01_1032200,132,11,4,147,0.8979591836734694,0.07482993197278912,0.027210884353741496
PVP01_1032100,50,11,0,61,0.819672131147541,0.18032786885245902,0
PVP01_1032000,1867,130,152,2149,0.8687761749651001,0.0604932526756631,0.07073057235923685
PVP01_1031900,757,32,16,805,0.9403726708074535,0.03975155279503106,0.01987577639751553
PVP01_1031800,709,12,107,828,0.856280193236715,0.014492753623188406,0.1292270531400966
PVP01_1030400,184,89,13,286,0.6433566433566433,0.3111888111888112,0.045454545454545456
PVP01_1030300,34,5,389,428,0.0794392523364486,0.011682242990654205,0.9088785046728972
PVP01_1030200,4964,2153,112,7229,0.6866786554156868,0.2978281920044266,0.015493152579886567
PVP01_1030100,4566,435,200,5201,0.8779080945971929,0.08363776196885214,0.03845414343395501
PVP01_1029900,83,10,423,516,0.16085271317829458,0.01937984496124031,0.8197674418604651
PVP01_1029800,245,18,1364,1627,0.1505838967424708,0.011063306699446834,0.8383527965580824
PVP01_1029700,228,9,3,240,0.95,0.0375,0.0125
PVP01_1029600,968,76,26,1070,0.9046728971962616,0.07102803738317758,0.024299065420560748
PVP01_1029500,5,1,4,10,0.5,0.1,0.4
PVP01_1029400,552,6,15,573,0.9633507853403142,0.010471204188481676,0.02617801047120419
PVP01_1029100,199,4,28,231,0.8614718614718615,0.017316017316017316,0.12121212121212122
PVP01_1028800,192,18,65,275,0.6981818181818182,0.06545454545454546,0.23636363636363636
PVP01_1028700,295,189,29,513,0.5750487329434698,0.3684210526315789,0.056530214424951264
PVP01_1028600,1224,60,27,1311,0.9336384439359268,0.04576659038901602,0.020594965675057208
PVP01_1028500,715,37,56,808,0.8849009900990099,0.04579207920792079,0.06930693069306931
PVP01_1028400,97,15,4,116,0.8362068965517241,0.12931034482758622,0.034482758620689655
PVP01_1028300,406,65,34,505,0.803960396039604,0.12871287128712872,0.06732673267326733
PVP01_1028200,78,16,0,94,0.8297872340425532,0.1702127659574468,0
PVP01_1028100,79,3,4,86,0.9186046511627907,0.03488372093023256,0.046511627906976744
PVP01_1028000,625,35,73,733,0.8526603001364257,0.047748976807639835,0.09959072305593451
PVP01_1027900,2481,2505,159,5145,0.4822157434402332,0.4868804664723032,0.030903790087463558
PVP01_1027800,114,123,7,244,0.4672131147540984,0.5040983606557377,0.028688524590163935
PVP01_1027700,880,107,302,1289,0.682699767261443,0.08301008533747091,0.2342901474010861
PVP01_1027600,6,1,1,8,0.75,0.125,0.125
PVP01_1027200,3521,2331,815,6667,0.5281235938203089,0.34963251837408127,0.12224388780560971
PVP01_1027100,1770,27,174,1971,0.898021308980213,0.0136986301369863,0.0882800608828006
PVP01_1027000,25,2,0,27,0.9259259259259259,0.07407407407407407,0
PVP01_1026900,12144,7271,389,19804,0.6132094526358312,0.3671480508988083,0.019642496465360534
PVP01_1026800,365,30,1212,1607,0.2271313005600498,0.018668326073428748,0.7542003733665215
PVP01_1026600,30,0,7,37,0.8108108108108109,0,0.1891891891891892
PVP01_1026400,1137,135,261,1533,0.7416829745596869,0.08806262230919765,0.17025440313111545
PVP01_1026300,1363,99,28,1490,0.9147651006711409,0.06644295302013423,0.01879194630872483
PVP01_1026200,1141,338,462,1941,0.5878413189077795,0.17413704276146316,0.23802163833075735
PVP01_1026100,190,12,34,236,0.8050847457627118,0.05084745762711865,0.1440677966101695
PVP01_1025900,404,52,514,970,0.41649484536082476,0.05360824742268041,0.5298969072164949
PVP01_1025600,17,2,4,23,0.7391304347826086,0.08695652173913043,0.17391304347826086
PVP01_1025500,1058,157,1380,2595,0.4077071290944123,0.0605009633911368,0.5317919075144508
PVP01_1025400,772,132,1035,1939,0.39814337287261475,0.06807632800412584,0.5337802991232594
PVP01_1025300,4184,579,208,4971,0.8416817541742104,0.11647555823777912,0.04184268758801046
PVP01_1025000,398,14,17,429,0.9277389277389277,0.03263403263403263,0.039627039627039624
PVP01_1024900,1866,48,57,1971,0.9467275494672754,0.0243531202435312,0.0289193302891933
PVP01_1024700,866,35,23,924,0.9372294372294372,0.03787878787878788,0.024891774891774892
PVP01_1024600,4376,1544,146,6066,0.7213979558193208,0.2545334652159578,0.024068578964721397
PVP01_1024500,403,14,8,425,0.9482352941176471,0.03294117647058824,0.018823529411764704
PVP01_1024200,2108,306,54,2468,0.8541329011345219,0.1239870340356564,0.02188006482982172
PVP01_1024100,788,38,25,851,0.9259694477085781,0.04465334900117509,0.02937720329024677
PVP01_1024000,82,4,11,97,0.845360824742268,0.041237113402061855,0.1134020618556701
PVP01_1023900,389,6,33,428,0.9088785046728972,0.014018691588785047,0.07710280373831775
PVP01_1023800,901,316,32,1249,0.7213771016813451,0.2530024019215372,0.025620496397117692
PVP01_1023700,0,0,5,5,0,0,1
PVP01_1023600,192,84,6,282,0.6808510638297872,0.2978723404255319,0.02127659574468085
PVP01_1023500,2157,69,200,2426,0.8891178895300906,0.028441879637262985,0.08244023083264633
PVP01_1023300,112,12,3,127,0.8818897637795275,0.09448818897637795,0.023622047244094488
PVP01_1023200,12,2,0,14,0.8571428571428571,0.14285714285714285,0
PVP01_1023000,2391,406,58,2855,0.8374781085814361,0.14220665499124344,0.020315236427320492
PVP01_1022900,57,9,2,68,0.8382352941176471,0.1323529411764706,0.029411764705882353
PVP01_1022800,1322,21,33,1376,0.9607558139534884,0.015261627906976744,0.023982558139534885
PVP01_1022700,865,96,173,1134,0.7627865961199295,0.08465608465608465,0.15255731922398588
PVP01_1022300,266,7,30,303,0.8778877887788779,0.0231023102310231,0.09900990099009901
PVP01_1022200,3613,289,108,4010,0.900997506234414,0.07206982543640898,0.026932668329177057
PVP01_1022100,643,42,71,756,0.8505291005291006,0.05555555555555555,0.09391534391534391
PVP01_1022000,1116,92,229,1437,0.7766179540709812,0.06402226861517049,0.1593597773138483
PVP01_1021900,213,21,8,242,0.8801652892561983,0.08677685950413223,0.03305785123966942
PVP01_1021800,725,49,22,796,0.9108040201005025,0.06155778894472362,0.02763819095477387
PVP01_1021700,1523,119,75,1717,0.8870122306348281,0.06930693069306931,0.043680838672102505
PVP01_1021600,114,5,24,143,0.7972027972027972,0.03496503496503497,0.16783216783216784
PVP01_1021300,1461,127,50,1638,0.891941391941392,0.07753357753357754,0.030525030525030524
PVP01_1021100,1130,102,139,1371,0.8242159008023341,0.07439824945295405,0.10138584974471189
PVP01_1021000,564,64,12,640,0.88125,0.1,0.01875
PVP01_1020900,8,2,18,28,0.2857142857142857,0.07142857142857142,0.6428571428571429
PVP01_1020800,412,25,366,803,0.5130759651307597,0.031133250311332503,0.45579078455790784
PVP01_1020700,494,82,260,836,0.5909090909090909,0.09808612440191387,0.31100478468899523
PVP01_1020600,1786,415,77,2278,0.7840210711150132,0.18217734855136083,0.033801580333625986
PVP01_1020400,69,20,48,137,0.5036496350364964,0.145985401459854,0.35036496350364965
PVP01_1020300,2837,34,57,2928,0.9689207650273224,0.011612021857923498,0.0194672131147541
PVP01_1020100,839,18,106,963,0.8712357217030114,0.018691588785046728,0.11007268951194185
PVP01_1020000,669,31,10,710,0.9422535211267605,0.04366197183098591,0.014084507042253521
PVP01_1019900,8,3,0,11,0.7272727272727273,0.2727272727272727,0
PVP01_1019800,672,33,116,821,0.8185140073081608,0.040194884287454324,0.14129110840438489
PVP01_1019700,1255,204,102,1561,0.8039718129404229,0.13068545803971812,0.06534272901985906
PVP01_1019600,2480,93,957,3530,0.7025495750708215,0.026345609065155807,0.2711048158640227
PVP01_1019400,21,4,10,35,0.6,0.11428571428571428,0.2857142857142857
PVP01_1019300,95,7,24,126,0.753968253968254,0.05555555555555555,0.19047619047619047
PVP01_1019200,1095,40,80,1215,0.9012345679012346,0.03292181069958848,0.06584362139917696
PVP01_1019000,61,13,8,82,0.7439024390243902,0.15853658536585366,0.0975609756097561
PVP01_1018900,1242,258,47,1547,0.8028442146089205,0.1667744020685197,0.030381383322559793
PVP01_1018700,46,5,7,58,0.7931034482758621,0.08620689655172414,0.1206896551724138
PVP01_1018600,1334,88,117,1539,0.866796621182586,0.057179987004548405,0.07602339181286549
PVP01_1018500,37,4,12,53,0.6981132075471698,0.07547169811320754,0.22641509433962265
PVP01_1018400,86,3,52,141,0.6099290780141844,0.02127659574468085,0.36879432624113473
PVP01_1018300,195,13,1001,1209,0.16129032258064516,0.010752688172043012,0.8279569892473119
PVP01_1018200,288,6,1357,1651,0.17443973349485162,0.0036341611144760752,0.8219261053906723
PVP01_1018100,62,13,1,76,0.8157894736842105,0.17105263157894737,0.013157894736842105
PVP01_1133000,518,84,139,741,0.699055330634278,0.11336032388663968,0.18758434547908232
PVP01_1132900,2802,41,1083,3926,0.7137035150280183,0.010443199184921039,0.27585328578706064
PVP01_1132800,2351,188,350,2889,0.8137763932156455,0.06507442021460713,0.12114918656974731
PVP01_1132700,1427,80,428,1935,0.7374677002583979,0.041343669250646,0.22118863049095608
PVP01_1132500,627,25,14,666,0.9414414414414415,0.03753753753753754,0.021021021021021023
PVP01_1132400,1002,36,75,1113,0.9002695417789758,0.03234501347708895,0.0673854447439353
PVP01_1132300,1105,57,182,1344,0.8221726190476191,0.04241071428571429,0.13541666666666666
PVP01_1132100,261,47,5,313,0.8338658146964856,0.1501597444089457,0.01597444089456869
PVP01_1132000,432,259,61,752,0.574468085106383,0.34441489361702127,0.08111702127659574
PVP01_1131900,9137,3520,258,12915,0.7074719318621757,0.27255129694154084,0.019976771196283393
PVP01_1131800,62,1,63,126,0.49206349206349204,0.007936507936507936,0.5
PVP01_1131700,19023,476,11845,31344,0.6069104134762634,0.01518631955079122,0.3779032669729454
PVP01_1131500,252,8,1738,1998,0.12612612612612611,0.004004004004004004,0.8698698698698699
PVP01_1131400,1188,42,24,1254,0.9473684210526315,0.03349282296650718,0.019138755980861243
PVP01_1131300,1893,522,53,2468,0.7670178282009724,0.21150729335494328,0.02147487844408428
PVP01_1131200,4782,2200,239,7221,0.6622351474864977,0.30466694363661545,0.03309790887688686
PVP01_1131100,14,23,33,70,0.2,0.32857142857142857,0.4714285714285714
PVP01_1131000,228,5,6,239,0.9539748953974896,0.02092050209205021,0.02510460251046025
PVP01_1130900,1159,134,23,1316,0.8806990881458967,0.10182370820668693,0.017477203647416412
PVP01_1130800,153,7,2,162,0.9444444444444444,0.043209876543209874,0.012345679012345678
PVP01_1130700,890,88,212,1190,0.7478991596638656,0.07394957983193277,0.17815126050420169
PVP01_1130600,1737,59,265,2061,0.8427947598253275,0.028626880155264434,0.12857836001940806
PVP01_1130500,314,62,108,484,0.6487603305785123,0.128099173553719,0.2231404958677686
PVP01_1130400,193,13,150,356,0.5421348314606742,0.03651685393258427,0.42134831460674155
PVP01_1130000,2593,549,158,3300,0.7857575757575758,0.16636363636363635,0.04787878787878788
PVP01_1129900,1022,87,164,1273,0.802827965435978,0.06834249803613511,0.12882953652788687
PVP01_1129800,1564,40,637,2241,0.6979027219991075,0.0178491744756805,0.28424810352521196
PVP01_1129600,778,169,291,1238,0.6284329563812601,0.13651050080775445,0.23505654281098545
PVP01_1129400,172,3,48,223,0.7713004484304933,0.013452914798206279,0.21524663677130046
PVP01_1129300,220,59,17,296,0.7432432432432432,0.19932432432432431,0.057432432432432436
PVP01_1129200,76,5,169,250,0.304,0.02,0.676
PVP01_1129000,322,105,26,453,0.7108167770419426,0.23178807947019867,0.05739514348785872
PVP01_1128900,5,1,0,6,0.8333333333333334,0.16666666666666666,0
PVP01_1128800,710,14,122,846,0.8392434988179669,0.016548463356973995,0.14420803782505912
PVP01_1128500,1644,473,335,2452,0.6704730831973899,0.19290375203915172,0.1366231647634584
PVP01_1128400,1782,23,1337,3142,0.5671546785486951,0.00732017823042648,0.4255251432208784
PVP01_1128300,266,109,8,383,0.6945169712793734,0.2845953002610966,0.020887728459530026
PVP01_1128200,305,478,33,816,0.3737745098039216,0.5857843137254902,0.04044117647058824
PVP01_1128100,27,10,8,45,0.6,0.2222222222222222,0.17777777777777778
PVP01_1128000,819,58,21,898,0.9120267260579065,0.0645879732739421,0.02338530066815145
PVP01_1127800,2145,366,80,2591,0.8278656889231957,0.14125820146661522,0.030876109610189117
PVP01_1127700,1514,978,54,2546,0.5946582875098193,0.38413197172034563,0.021209740769835034
PVP01_1127600,1589,523,45,2157,0.7366713027352805,0.24246638850254984,0.02086230876216968
PVP01_1127500,184,26,3,213,0.863849765258216,0.12206572769953052,0.014084507042253521
PVP01_1127300,635,238,28,901,0.704772475027747,0.2641509433962264,0.03107658157602664
PVP01_1127200,986,80,23,1089,0.9054178145087236,0.07346189164370982,0.021120293847566574
PVP01_1127100,34,2,0,36,0.9444444444444444,0.05555555555555555,0
PVP01_1127000,506,64,133,703,0.7197724039829303,0.09103840682788052,0.1891891891891892
PVP01_1126900,869,40,128,1037,0.8379942140790743,0.03857280617164899,0.12343297974927676
PVP01_1126800,234,17,2,253,0.924901185770751,0.06719367588932806,0.007905138339920948
PVP01_1126700,1107,375,48,1530,0.7235294117647059,0.24509803921568626,0.03137254901960784
PVP01_1126500,2047,120,51,2218,0.9229035166816952,0.05410279531109107,0.022993688007213707
PVP01_1126400,1379,479,124,1982,0.6957618567103936,0.24167507568113017,0.06256306760847628
PVP01_1126300,440,59,376,875,0.5028571428571429,0.06742857142857143,0.4297142857142857
PVP01_1126200,177,4,20,201,0.8805970149253731,0.01990049751243781,0.09950248756218906
PVP01_1126100,346,10,75,431,0.802784222737819,0.02320185614849188,0.1740139211136891
PVP01_1125900,636,492,106,1234,0.5153970826580226,0.3987034035656402,0.08589951377633712
PVP01_1125800,1421,105,179,1705,0.8334310850439882,0.06158357771260997,0.10498533724340176
PVP01_1125600,229,12,7,248,0.9233870967741935,0.04838709677419355,0.028225806451612902
PVP01_1125500,2749,701,88,3538,0.776992651215376,0.19813453928773317,0.0248728094968909
PVP01_1125400,301,12,5,318,0.9465408805031447,0.03773584905660377,0.015723270440251572
PVP01_1125300,1335,41,32,1408,0.9481534090909091,0.02911931818181818,0.022727272727272728
PVP01_1125200,117,8,4,129,0.9069767441860465,0.06201550387596899,0.031007751937984496
PVP01_1125100,1584,153,51,1788,0.8859060402684564,0.08557046979865772,0.028523489932885907
PVP01_1125000,101,1,3,105,0.9619047619047619,0.009523809523809525,0.02857142857142857
PVP01_1124900,5178,896,541,6615,0.7827664399092971,0.13544973544973546,0.08178382464096749
PVP01_1124800,869,37,30,936,0.9284188034188035,0.03952991452991453,0.03205128205128205
PVP01_1124700,13,0,2,15,0.8666666666666667,0,0.13333333333333333
PVP01_1124500,25,6,13,44,0.5681818181818182,0.13636363636363635,0.29545454545454547
PVP01_1124400,13,1,0,14,0.9285714285714286,0.07142857142857142,0
PVP01_1124000,196,5,260,461,0.42516268980477223,0.010845986984815618,0.5639913232104121
PVP01_1123900,473,56,115,644,0.734472049689441,0.08695652173913043,0.17857142857142858
PVP01_1123800,175,10,9,194,0.9020618556701031,0.05154639175257732,0.04639175257731959
PVP01_1123500,92,13,9,114,0.8070175438596491,0.11403508771929824,0.07894736842105263
PVP01_1123400,242,7,1,250,0.968,0.028,0.004
PVP01_1123300,196,56,8,260,0.7538461538461538,0.2153846153846154,0.03076923076923077
PVP01_1123200,17,2,9,28,0.6071428571428571,0.07142857142857142,0.32142857142857145
PVP01_1123000,167,6,7,180,0.9277777777777778,0.03333333333333333,0.03888888888888889
PVP01_1122900,287,17,8,312,0.9198717948717948,0.05448717948717949,0.02564102564102564
PVP01_1122800,462,27,4,493,0.9371196754563894,0.05476673427991886,0.008113590263691683
PVP01_1122700,2094,708,57,2859,0.7324239244491081,0.24763903462749212,0.01993704092339979
PVP01_1122600,731,26,15,772,0.9468911917098446,0.03367875647668394,0.019430051813471502
PVP01_1122500,10,1,0,11,0.9090909090909091,0.09090909090909091,0
PVP01_1122400,730,539,497,1766,0.41336353340883353,0.3052095130237826,0.2814269535673839
PVP01_1122200,1213,209,36,1458,0.8319615912208504,0.14334705075445817,0.024691358024691357
PVP01_1122100,9,0,1,10,0.9,0,0.1
PVP01_1122000,1715,166,82,1963,0.8736627610799796,0.08456444218033622,0.041772796739684155
PVP01_1121800,214,72,89,375,0.5706666666666667,0.192,0.23733333333333334
PVP01_1121700,1293,307,65,1665,0.7765765765765765,0.1843843843843844,0.03903903903903904
PVP01_1121600,743,57,14,814,0.9127764127764127,0.07002457002457002,0.0171990171990172
PVP01_1121500,286,14,11,311,0.9196141479099679,0.04501607717041801,0.03536977491961415
PVP01_1121400,409,38,3954,4401,0.09293342422176779,0.008634401272438082,0.8984321745057942
PVP01_1121300,773,299,47,1119,0.6907953529937444,0.26720285969615726,0.0420017873100983
PVP01_1121200,2405,1729,132,4266,0.5637599624941397,0.4052977027660572,0.030942334739803096
PVP01_1121100,9,0,1,10,0.9,0,0.1
PVP01_1121000,54,2,2,58,0.9310344827586207,0.034482758620689655,0.034482758620689655
PVP01_1120900,1659,186,302,2147,0.7727061015370285,0.08663251047973917,0.1406613879832324
PVP01_1120800,967,312,145,1424,0.6790730337078652,0.21910112359550563,0.10182584269662921
PVP01_1120700,1127,118,21,1266,0.8902053712480252,0.09320695102685624,0.016587677725118485
PVP01_1120500,683,98,18,799,0.8548185231539425,0.12265331664580725,0.02252816020025031
PVP01_1120400,343,118,16,477,0.7190775681341719,0.24737945492662475,0.033542976939203356
PVP01_1120300,2493,195,88,2776,0.8980547550432276,0.07024495677233429,0.03170028818443804
PVP01_1120200,454,11,619,1084,0.4188191881918819,0.01014760147601476,0.5710332103321033
PVP01_1120100,88,144,5,237,0.37130801687763715,0.6075949367088608,0.02109704641350211
PVP01_1120000,1710,486,142,2338,0.7313943541488451,0.20786997433704021,0.06073567151411463
PVP01_1119900,109,57,11,177,0.615819209039548,0.3220338983050847,0.062146892655367235
PVP01_1119700,210,20,7,237,0.8860759493670886,0.08438818565400844,0.029535864978902954
PVP01_1119600,22,4,0,26,0.8461538461538461,0.15384615384615385,0
PVP01_1119500,214,9,66,289,0.740484429065744,0.031141868512110725,0.22837370242214533
PVP01_1119300,23,8,45,76,0.3026315789473684,0.10526315789473684,0.5921052631578947
PVP01_1119200,2161,66,66,2293,0.9424334932402966,0.02878325337985172,0.02878325337985172
PVP01_1119100,106,4,220,330,0.3212121212121212,0.012121212121212121,0.6666666666666666
PVP01_1119000,205,349,22,576,0.3559027777777778,0.6059027777777778,0.03819444444444445
PVP01_1118900,869,51,33,953,0.9118572927597062,0.053515215110178385,0.03462749213011543
PVP01_1118800,212,67,27,306,0.6928104575163399,0.21895424836601307,0.08823529411764706
PVP01_1118700,105,5,117,227,0.46255506607929514,0.022026431718061675,0.5154185022026432
PVP01_1118600,635,838,56,1529,0.41530412034009156,0.5480706344015697,0.03662524525833878
PVP01_1118300,1407,347,56,1810,0.7773480662983425,0.19171270718232045,0.030939226519337018
PVP01_1118200,373,24,6,403,0.9255583126550868,0.05955334987593052,0.01488833746898263
PVP01_1118100,203,37,72,312,0.6506410256410257,0.11858974358974358,0.23076923076923078
PVP01_1118000,18,2,0,20,0.9,0.1,0
PVP01_1117900,467,23,10,500,0.934,0.046,0.02
PVP01_1117800,3804,268,120,4192,0.9074427480916031,0.06393129770992366,0.02862595419847328
PVP01_1117600,1288,147,414,1849,0.6965927528393726,0.07950243374797188,0.2239048134126555
PVP01_1117500,2406,3311,215,5932,0.4055967633175995,0.5581591368846932,0.03624409979770735
PVP01_1117400,57,17,3,77,0.7402597402597403,0.22077922077922077,0.03896103896103896
PVP01_1117300,114,26,2,142,0.8028169014084507,0.18309859154929578,0.014084507042253521
PVP01_1117200,293,186,116,595,0.492436974789916,0.3126050420168067,0.1949579831932773
PVP01_1116900,2172,65,99,2336,0.9297945205479452,0.027825342465753425,0.04238013698630137
PVP01_1116800,1012,12,19,1043,0.9702780441035475,0.011505273250239693,0.01821668264621285
PVP01_1116700,264,32,21,317,0.832807570977918,0.10094637223974763,0.06624605678233439
PVP01_1116600,423,159,54,636,0.6650943396226415,0.25,0.08490566037735849
PVP01_1116400,237,125,31,393,0.6030534351145038,0.31806615776081426,0.07888040712468193
PVP01_1116200,146,48,19,213,0.6854460093896714,0.22535211267605634,0.0892018779342723
PVP01_1116100,405,115,13,533,0.7598499061913696,0.21575984990619138,0.024390243902439025
PVP01_1116000,316,45,10,371,0.8517520215633423,0.12129380053908356,0.026954177897574125
PVP01_1115800,1678,88,54,1820,0.921978021978022,0.04835164835164835,0.02967032967032967
PVP01_1115700,70,22,0,92,0.7608695652173914,0.2391304347826087,0
PVP01_1115600,198,12,5,215,0.9209302325581395,0.05581395348837209,0.023255813953488372
PVP01_1115500,124,2,2,128,0.96875,0.015625,0.015625
PVP01_1115400,1,0,0,1,1,0,0
PVP01_1115300,669,24,887,1580,0.4234177215189873,0.015189873417721518,0.5613924050632911
PVP01_1115200,166,16,9,191,0.8691099476439791,0.08376963350785341,0.04712041884816754
PVP01_1115000,153,4,7,164,0.9329268292682927,0.024390243902439025,0.042682926829268296
PVP01_1114700,457,6,18,481,0.9501039501039501,0.012474012474012475,0.037422037422037424
PVP01_1114600,0,0,0,0,NaN,NaN,NaN
PVP01_1114400,364,15,38,417,0.8729016786570744,0.03597122302158273,0.09112709832134293
PVP01_1114300,29,8,1,38,0.7631578947368421,0.21052631578947367,0.02631578947368421
PVP01_1114200,601,518,15,1134,0.5299823633156967,0.4567901234567901,0.013227513227513227
PVP01_1114100,628,75,19,722,0.8698060941828255,0.1038781163434903,0.02631578947368421
PVP01_1114000,487,30,17,534,0.9119850187265918,0.056179775280898875,0.031835205992509365
PVP01_1113900,1025,63,43,1131,0.9062776304155614,0.05570291777188329,0.03801945181255526
PVP01_1113600,186,3,29,218,0.8532110091743119,0.013761467889908258,0.13302752293577982
PVP01_1113500,146,5,72,223,0.6547085201793722,0.02242152466367713,0.32286995515695066
PVP01_1113400,609,470,38,1117,0.5452103849597135,0.42076991942703673,0.03401969561324977
PVP01_1113300,60,13,61,134,0.44776119402985076,0.09701492537313433,0.4552238805970149
PVP01_1113200,97,26,3,126,0.7698412698412699,0.20634920634920634,0.023809523809523808
PVP01_1113100,4136,1849,135,6120,0.6758169934640523,0.30212418300653593,0.022058823529411766
PVP01_1113000,392,87,7,486,0.8065843621399177,0.17901234567901234,0.01440329218106996
PVP01_1112900,336,285,89,710,0.4732394366197183,0.4014084507042254,0.12535211267605634
PVP01_1112800,1033,175,30,1238,0.8344103392568659,0.14135702746365106,0.024232633279483037
PVP01_1112700,424,13,62,499,0.8496993987975952,0.026052104208416832,0.12424849699398798
PVP01_1112600,1179,177,119,1475,0.7993220338983051,0.12,0.08067796610169492
PVP01_1112100,15,0,27,42,0.35714285714285715,0,0.6428571428571429
PVP01_1112000,1878,271,106,2255,0.8328159645232815,0.12017738359201774,0.04700665188470066
PVP01_1111900,12,1,2,15,0.8,0.06666666666666667,0.13333333333333333
PVP01_1111800,308,99,150,557,0.5529622980251346,0.17773788150807898,0.26929982046678635
PVP01_1111700,453,26,20,499,0.9078156312625251,0.052104208416833664,0.04008016032064128
PVP01_1111600,220,8,6,234,0.9401709401709402,0.03418803418803419,0.02564102564102564
PVP01_1111500,915,169,26,1110,0.8243243243243243,0.15225225225225225,0.023423423423423424
PVP01_1111400,54,1,11,66,0.8181818181818182,0.015151515151515152,0.16666666666666666
PVP01_1111300,356,60,183,599,0.5943238731218697,0.1001669449081803,0.3055091819699499
PVP01_1111200,3772,524,266,4562,0.8268303375712407,0.11486190267426567,0.05830775975449364
PVP01_1111000,398,194,10,602,0.6611295681063123,0.3222591362126246,0.016611295681063124
PVP01_1110900,450,56,95,601,0.7487520798668885,0.09317803660565724,0.15806988352745424
PVP01_1110700,71,6,1,78,0.9102564102564102,0.07692307692307693,0.01282051282051282
PVP01_1110400,48,1,14,63,0.7619047619047619,0.015873015873015872,0.2222222222222222
PVP01_1110300,309,5,120,434,0.7119815668202765,0.01152073732718894,0.2764976958525346
PVP01_1110200,1176,23,82,1281,0.9180327868852459,0.01795472287275566,0.06401249024199844
PVP01_1110100,2086,71,57,2214,0.9421860885275519,0.032068654019873535,0.025745257452574527
PVP01_1110000,251,8,98,357,0.7030812324929971,0.022408963585434174,0.27450980392156865
PVP01_1109900,20,1,6,27,0.7407407407407407,0.037037037037037035,0.2222222222222222
PVP01_1109800,201,50,8,259,0.7760617760617761,0.19305019305019305,0.03088803088803089
PVP01_1109700,1072,114,34,1220,0.8786885245901639,0.09344262295081968,0.027868852459016394
PVP01_1109600,2717,551,675,3943,0.6890692366218615,0.13974131372051737,0.1711894496576211
PVP01_1109500,334,19,13,366,0.912568306010929,0.05191256830601093,0.03551912568306011
PVP01_1109400,116,10,10,136,0.8529411764705882,0.07352941176470588,0.07352941176470588
PVP01_1109200,343,10,771,1124,0.30516014234875444,0.008896797153024912,0.6859430604982206
PVP01_1109000,970,95,25,1090,0.8899082568807339,0.0871559633027523,0.022935779816513763
PVP01_1108900,1638,250,58,1946,0.841726618705036,0.12846865364850976,0.029804727646454265
PVP01_1108800,942,32,17,991,0.9505549949545913,0.03229061553985873,0.017154389505549948
PVP01_1108700,252,10,8,270,0.9333333333333333,0.037037037037037035,0.02962962962962963
PVP01_1108600,767,95,21,883,0.8686296715741789,0.10758776896942242,0.02378255945639864
PVP01_1108500,213,33,6,252,0.8452380952380952,0.13095238095238096,0.023809523809523808
PVP01_1108400,100,8,3,111,0.9009009009009009,0.07207207207207207,0.02702702702702703
PVP01_1108300,1475,80,27,1582,0.9323640960809102,0.05056890012642225,0.01706700379266751
PVP01_1108200,12,0,2,14,0.8571428571428571,0,0.14285714285714285
PVP01_1108000,723,46,305,1074,0.6731843575418994,0.04283054003724395,0.2839851024208566
PVP01_1107500,853,83,18,954,0.8941299790356394,0.0870020964360587,0.018867924528301886
PVP01_1107400,2852,120,65,3037,0.9390846229832072,0.03951267698386566,0.02140270003292723
PVP01_1107200,84,32,3,119,0.7058823529411765,0.2689075630252101,0.025210084033613446
PVP01_1107100,124,8,1,133,0.9323308270676691,0.06015037593984962,0.007518796992481203
PVP01_1107000,927,109,21,1057,0.8770104068117314,0.10312204351939451,0.019867549668874173
PVP01_1106800,361,39,9,409,0.882640586797066,0.09535452322738386,0.022004889975550123
PVP01_1106600,476,235,16,727,0.6547455295735901,0.32324621733149933,0.022008253094910592
PVP01_1106500,408,65,8,481,0.8482328482328483,0.13513513513513514,0.016632016632016633
PVP01_1106400,172,4,32,208,0.8269230769230769,0.019230769230769232,0.15384615384615385
PVP01_1106300,139,12,291,442,0.31447963800904977,0.027149321266968326,0.6583710407239819
PVP01_1106200,1306,92,635,2033,0.6424003935071323,0.04525332021642892,0.31234628627643873
PVP01_1106100,2030,1080,535,3645,0.5569272976680384,0.2962962962962963,0.1467764060356653
PVP01_1106000,224,108,20,352,0.6363636363636364,0.3068181818181818,0.056818181818181816
PVP01_1105900,3,1,85,89,0.033707865168539325,0.011235955056179775,0.9550561797752809
PVP01_1105800,266,17,4,287,0.926829268292683,0.059233449477351915,0.013937282229965157
PVP01_1105700,370,168,70,608,0.6085526315789473,0.27631578947368424,0.11513157894736842
PVP01_1105500,354,6,16,376,0.9414893617021277,0.015957446808510637,0.0425531914893617
PVP01_1105400,738,159,51,948,0.7784810126582279,0.16772151898734178,0.05379746835443038
PVP01_1105200,475,34,45,554,0.8574007220216606,0.061371841155234655,0.0812274368231047
PVP01_1105000,1629,138,36,1803,0.9034941763727121,0.07653910149750416,0.019966722129783693
PVP01_1104900,2388,495,83,2966,0.8051247471341875,0.16689143627781525,0.027983816587997302
PVP01_1104800,19,4,2,25,0.76,0.16,0.08
PVP01_1104700,384,65,26,475,0.8084210526315789,0.1368421052631579,0.05473684210526316
PVP01_1104600,775,727,79,1581,0.49019607843137253,0.45983554712207464,0.04996837444655281
PVP01_1104500,136,3,5,144,0.9444444444444444,0.020833333333333332,0.034722222222222224
PVP01_1104400,17,35,4,56,0.30357142857142855,0.625,0.07142857142857142
PVP01_1104300,1792,327,86,2205,0.8126984126984127,0.14829931972789115,0.039002267573696146
PVP01_1104000,518,8,46,572,0.9055944055944056,0.013986013986013986,0.08041958041958042
PVP01_1103900,1398,100,117,1615,0.8656346749226006,0.06191950464396285,0.07244582043343653
PVP01_1103800,616,102,74,792,0.7777777777777778,0.12878787878787878,0.09343434343434344
PVP01_1103700,354,4,88,446,0.7937219730941704,0.008968609865470852,0.19730941704035873
PVP01_1103600,1298,44,680,2022,0.6419386745796242,0.021760633036597428,0.3363006923837784
PVP01_1103500,1201,99,363,1663,0.7221888153938665,0.05953096812988575,0.21828021647624773
PVP01_1103400,117,14,5,136,0.8602941176470589,0.10294117647058823,0.03676470588235294
PVP01_1103300,599,60,13,672,0.8913690476190477,0.08928571428571429,0.019345238095238096
PVP01_1103200,743,34,20,797,0.9322459222082811,0.04265997490589712,0.025094102885821833
PVP01_1103100,259,5,64,328,0.7896341463414634,0.01524390243902439,0.1951219512195122
PVP01_1103000,490,8,11,509,0.962671905697446,0.015717092337917484,0.021611001964636542
PVP01_1102600,177,18,3,198,0.8939393939393939,0.09090909090909091,0.015151515151515152
PVP01_1102400,1982,62,57,2101,0.9433603046168492,0.029509757258448358,0.027129938124702522
PVP01_1102300,69,70,2,141,0.48936170212765956,0.49645390070921985,0.014184397163120567
PVP01_0802100,47,1,2,50,0.94,0.02,0.04
PVP01_0802200,1732,933,129,2794,0.6198997852541159,0.3339298496778812,0.046170365068002865
PVP01_0802300,203,11,2,216,0.9398148148148148,0.05092592592592592,0.009259259259259259
PVP01_0802500,746,15,30,791,0.943109987357775,0.018963337547408345,0.03792667509481669
PVP01_0802700,60,7,47,114,0.5263157894736842,0.06140350877192982,0.41228070175438597
PVP01_0802800,71,3,142,216,0.3287037037037037,0.013888888888888888,0.6574074074074074
PVP01_0802900,22,0,5,27,0.8148148148148148,0,0.18518518518518517
PVP01_0803000,360,28,6,394,0.9137055837563451,0.07106598984771574,0.015228426395939087
PVP01_0803100,80,36,6,122,0.6557377049180327,0.29508196721311475,0.04918032786885246
PVP01_0803400,53,33,1596,1682,0.03151010701545779,0.019619500594530322,0.9488703923900119
PVP01_0803500,599,54,17,670,0.8940298507462686,0.08059701492537313,0.025373134328358207
PVP01_0803700,867,165,28,1060,0.8179245283018868,0.15566037735849056,0.026415094339622643
PVP01_0803800,16992,9659,645,27296,0.6225087924970691,0.3538613716295428,0.02362983587338804
PVP01_0803900,1893,383,79,2355,0.8038216560509555,0.16263269639065817,0.03354564755838641
PVP01_0804000,651,348,121,1120,0.58125,0.3107142857142857,0.10803571428571429
PVP01_0804100,699,213,34,946,0.7389006342494715,0.2251585623678647,0.035940803382663845
PVP01_0804200,2201,383,836,3420,0.6435672514619883,0.11198830409356725,0.24444444444444444
PVP01_0804400,375,23,9,407,0.9213759213759214,0.056511056511056514,0.022113022113022112
PVP01_0804500,26,3,3,32,0.8125,0.09375,0.09375
PVP01_0804600,508,23,19,550,0.9236363636363636,0.04181818181818182,0.034545454545454546
PVP01_0804800,647,570,72,1289,0.5019394879751745,0.4422032583397983,0.055857253685027156
PVP01_0804900,12,0,0,12,1,0,0
PVP01_0805000,1,0,17,18,0.05555555555555555,0,0.9444444444444444
PVP01_0805100,2,0,0,2,1,0,0
PVP01_0805200,1624,38,47,1709,0.9502633118782914,0.022235225277940317,0.027501462843768285
PVP01_0805300,728,611,402,1741,0.41815048822515793,0.3509477311889719,0.2309017805858702
PVP01_0805400,423,40,724,1187,0.35636057287278855,0.03369839932603201,0.6099410278011794
PVP01_0805500,0,0,5,5,0,0,1
PVP01_0805600,2634,72,112,2818,0.9347054648687012,0.0255500354861604,0.0397444996451384
PVP01_0805700,24,2,8,34,0.7058823529411765,0.058823529411764705,0.23529411764705882
PVP01_0805800,187,8,6,201,0.9303482587064676,0.03980099502487562,0.029850746268656716
PVP01_0805900,266,100,15,381,0.6981627296587927,0.26246719160104987,0.03937007874015748
PVP01_0806000,29,7,8,44,0.6590909090909091,0.1590909090909091,0.18181818181818182
PVP01_0806100,365,17,13,395,0.9240506329113924,0.043037974683544304,0.03291139240506329
PVP01_0806200,609,20,12,641,0.9500780031201248,0.031201248049921998,0.0187207488299532
PVP01_0806400,2071,362,51,2484,0.8337359098228664,0.1457326892109501,0.020531400966183576
PVP01_0806500,1622,630,88,2340,0.6931623931623931,0.2692307692307692,0.037606837606837605
PVP01_0806700,920,34,43,997,0.9227683049147443,0.034102306920762285,0.04312938816449348
PVP01_0806800,6,2,5,13,0.46153846153846156,0.15384615384615385,0.38461538461538464
PVP01_0806900,818,17,49,884,0.9253393665158371,0.019230769230769232,0.05542986425339366
PVP01_0807000,2,3,234,239,0.008368200836820083,0.012552301255230125,0.9790794979079498
PVP01_0807100,1299,37,430,1766,0.7355605889014722,0.020951302378255945,0.2434881087202718
PVP01_0807200,91,17,74,182,0.5,0.09340659340659341,0.4065934065934066
PVP01_0807300,338,11,20,369,0.9159891598915989,0.02981029810298103,0.05420054200542006
PVP01_0807600,2619,993,79,3691,0.7095638038471959,0.26903278244378215,0.021403413709021945
PVP01_0807900,1880,35,232,2147,0.8756404285048905,0.016301816488122962,0.10805775500698649
PVP01_0808100,1622,118,73,1813,0.894649751792609,0.06508549365692223,0.04026475455046884
PVP01_0808200,312,17,688,1017,0.30678466076696165,0.01671583087512291,0.6764995083579154
PVP01_0808400,110,2,6,118,0.9322033898305084,0.01694915254237288,0.05084745762711865
PVP01_0808500,1109,1703,107,2919,0.37992463172319285,0.5834189791024323,0.03665638917437478
PVP01_0808900,1872,347,75,2294,0.8160418482999128,0.15126416739319964,0.03269398430688753
PVP01_0809000,601,228,30,859,0.69965075669383,0.26542491268917345,0.034924330616996506
PVP01_0809200,780,118,19,917,0.8505997818974919,0.128680479825518,0.020719738276990186
PVP01_0809300,185,24,5,214,0.8644859813084113,0.11214953271028037,0.02336448598130841
PVP01_0809400,422,73,18,513,0.8226120857699805,0.14230019493177387,0.03508771929824561
PVP01_0809500,541,105,374,1020,0.5303921568627451,0.10294117647058823,0.36666666666666664
PVP01_0809700,9,3,462,474,0.0189873417721519,0.006329113924050633,0.9746835443037974
PVP01_0809800,154,13,8,175,0.88,0.07428571428571429,0.045714285714285714
PVP01_0810000,86,11,2,99,0.8686868686868687,0.1111111111111111,0.020202020202020204
PVP01_0810100,1097,40,39,1176,0.9328231292517006,0.034013605442176874,0.03316326530612245
PVP01_0810200,1158,51,39,1248,0.9278846153846154,0.040865384615384616,0.03125
PVP01_0810400,141,339,15,495,0.28484848484848485,0.6848484848484848,0.030303030303030304
PVP01_0810500,96,1,15,112,0.8571428571428571,0.008928571428571428,0.13392857142857142
PVP01_0810600,2,0,0,2,1,0,0
PVP01_0810700,21,11,0,32,0.65625,0.34375,0
PVP01_0810800,484,51,65,600,0.8066666666666666,0.085,0.10833333333333334
PVP01_0810900,599,39,19,657,0.9117199391171994,0.0593607305936073,0.0289193302891933
PVP01_0811000,550,20,17,587,0.9369676320272572,0.034071550255536626,0.028960817717206135
PVP01_0811100,3,0,2,5,0.6,0,0.4
PVP01_0811200,407,35,129,571,0.712784588441331,0.06129597197898424,0.22591943957968477
PVP01_0811300,195,42,35,272,0.7169117647058824,0.15441176470588236,0.12867647058823528
PVP01_0811400,570,9,80,659,0.8649468892261002,0.013657056145675266,0.12139605462822459
PVP01_0811500,1545,110,37,1692,0.9131205673758865,0.06501182033096926,0.02186761229314421
PVP01_0811600,34,1,10,45,0.7555555555555555,0.022222222222222223,0.2222222222222222
PVP01_0811700,839,82,35,956,0.8776150627615062,0.08577405857740586,0.036610878661087864
PVP01_0811800,1717,176,47,1940,0.8850515463917525,0.09072164948453608,0.02422680412371134
PVP01_0811900,3184,4322,155,7661,0.4156115389635818,0.5641561153896358,0.020232345646782404
PVP01_0812000,1137,54,195,1386,0.8203463203463204,0.03896103896103896,0.1406926406926407
PVP01_0812100,364,14,232,610,0.5967213114754099,0.022950819672131147,0.380327868852459
PVP01_0812200,973,103,1300,2376,0.4095117845117845,0.04335016835016835,0.5471380471380471
PVP01_0812300,313,32,5381,5726,0.05466294097100943,0.005588543485853999,0.9397485155431365
PVP01_0812400,788,26,293,1107,0.7118337850045167,0.023486901535682024,0.2646793134598013
PVP01_0812500,60,29,7,96,0.625,0.3020833333333333,0.07291666666666667
PVP01_0812600,15,8,3,26,0.5769230769230769,0.3076923076923077,0.11538461538461539
PVP01_0812700,429,196,25,650,0.66,0.30153846153846153,0.038461538461538464
PVP01_0812800,965,94,169,1228,0.7858306188925082,0.07654723127035831,0.13762214983713356
PVP01_0812900,1050,115,25,1190,0.8823529411764706,0.09663865546218488,0.02100840336134454
PVP01_0813000,295,56,18,369,0.7994579945799458,0.15176151761517614,0.04878048780487805
PVP01_0813200,1145,1185,116,2446,0.4681112019623876,0.48446443172526577,0.047424366312346686
PVP01_0813400,1313,27,41,1381,0.9507603186097031,0.01955104996379435,0.029688631426502535
PVP01_0813500,268,55,16,339,0.7905604719764012,0.16224188790560473,0.0471976401179941
PVP01_0813600,616,147,363,1126,0.5470692717584369,0.130550621669627,0.32238010657193605
PVP01_0813800,453,7,17,477,0.949685534591195,0.014675052410901468,0.03563941299790356
PVP01_0814000,1899,145,47,2091,0.9081779053084649,0.06934481109516978,0.022477283596365374
PVP01_0814100,36,1,244,281,0.12811387900355872,0.0035587188612099642,0.8683274021352313
PVP01_0814200,54,9,3017,3080,0.01753246753246753,0.002922077922077922,0.9795454545454545
PVP01_0814300,60,0,0,60,1,0,0
PVP01_0814500,761,29,20,810,0.9395061728395062,0.03580246913580247,0.024691358024691357
PVP01_0814700,1197,484,308,1989,0.6018099547511312,0.2433383609854198,0.15485168426344897
PVP01_0814800,287,15,8,310,0.9258064516129032,0.04838709677419355,0.025806451612903226
PVP01_0814900,123,1,7,131,0.9389312977099237,0.007633587786259542,0.05343511450381679
PVP01_0815100,75,4,34,113,0.6637168141592921,0.035398230088495575,0.3008849557522124
PVP01_0815200,1044,240,37,1321,0.7903103709311128,0.18168054504163514,0.028009084027252083
PVP01_0815300,1179,200,36,1415,0.8332155477031802,0.1413427561837456,0.025441696113074206
PVP01_0815400,308,90,11,409,0.7530562347188264,0.2200488997555012,0.02689486552567237
PVP01_0815700,682,111,14,807,0.8451053283767038,0.137546468401487,0.01734820322180917
PVP01_0815800,337,18,14,369,0.9132791327913279,0.04878048780487805,0.037940379403794036
PVP01_0815900,4261,70,137,4468,0.9536705461056401,0.01566696508504924,0.030662488809310655
PVP01_0816000,8245,1437,334,10016,0.8231829073482428,0.14347044728434505,0.033346645367412144
PVP01_0816100,38,1,381,420,0.09047619047619047,0.002380952380952381,0.9071428571428571
PVP01_0816200,19,2,0,21,0.9047619047619048,0.09523809523809523,0
PVP01_0816300,642,36,124,802,0.800498753117207,0.04488778054862843,0.1546134663341646
PVP01_0816500,3076,820,304,4200,0.7323809523809524,0.19523809523809524,0.07238095238095238
PVP01_0816600,2514,557,85,3156,0.7965779467680608,0.176489226869455,0.026932826362484157
PVP01_0816700,1298,143,498,1939,0.669417225373904,0.073749355337803,0.25683341928829295
PVP01_0816800,182,12,678,872,0.20871559633027523,0.013761467889908258,0.7775229357798165
PVP01_0816900,72,10,0,82,0.8780487804878049,0.12195121951219512,0
PVP01_0817000,503,14,96,613,0.8205546492659054,0.022838499184339316,0.1566068515497553
PVP01_0817100,488,112,73,673,0.725111441307578,0.1664190193164933,0.10846953937592868
PVP01_0817200,829,74,59,962,0.8617463617463618,0.07692307692307693,0.061330561330561334
PVP01_0817300,7161,3217,219,10597,0.6757572897989997,0.3035764839105407,0.020666226290459565
PVP01_0817400,51,0,14,65,0.7846153846153846,0,0.2153846153846154
PVP01_0817600,608,72,20,700,0.8685714285714285,0.10285714285714286,0.02857142857142857
PVP01_0817800,557,402,17,976,0.5706967213114754,0.41188524590163933,0.017418032786885244
PVP01_0817900,709,79,27,815,0.8699386503067484,0.09693251533742331,0.033128834355828224
PVP01_0818000,446,10,93,549,0.8123861566484517,0.018214936247723135,0.16939890710382513
PVP01_0818100,134,19,4,157,0.8535031847133758,0.12101910828025478,0.025477707006369428
PVP01_0818200,263,82,13,358,0.7346368715083799,0.22905027932960895,0.036312849162011177
PVP01_0818300,909,335,213,1457,0.6238846945778997,0.2299245024021963,0.14619080301990392
PVP01_0818600,1911,822,115,2848,0.670997191011236,0.288623595505618,0.04037921348314607
PVP01_0818700,1585,450,47,2082,0.7612872238232469,0.21613832853025935,0.022574447646493755
PVP01_0818800,46,2,181,229,0.20087336244541484,0.008733624454148471,0.7903930131004366
PVP01_0819000,21,1,2,24,0.875,0.041666666666666664,0.08333333333333333
PVP01_0819300,2116,187,2859,5162,0.4099186361875242,0.03622626888802789,0.5538550949244478
PVP01_0819400,230,18,12,260,0.8846153846153846,0.06923076923076923,0.046153846153846156
PVP01_0819500,124,10,5,139,0.8920863309352518,0.07194244604316546,0.03597122302158273
PVP01_0819600,346,10,37,393,0.8804071246819338,0.02544529262086514,0.09414758269720101
PVP01_0819700,402,2467,351,3220,0.1248447204968944,0.7661490683229814,0.10900621118012423
PVP01_0819800,627,65,15,707,0.8868458274398868,0.09193776520509193,0.021216407355021217
PVP01_0820100,579,47,152,778,0.7442159383033419,0.060411311053984576,0.1953727506426735
PVP01_0820200,772,58,67,897,0.8606465997770345,0.06465997770345597,0.07469342251950947
PVP01_0820300,275,3,35,313,0.8785942492012779,0.009584664536741214,0.11182108626198083
PVP01_0820400,68,3,4,75,0.9066666666666666,0.04,0.05333333333333334
PVP01_0108800,2520,411,77,3008,0.8377659574468085,0.13663563829787234,0.02559840425531915
PVP01_0108900,7,0,1,8,0.875,0,0.125
PVP01_0109000,412,12,149,573,0.7190226876090751,0.020942408376963352,0.2600349040139616
PVP01_0109100,5368,1456,183,7007,0.7660910518053375,0.2077922077922078,0.026116740402454687
PVP01_0109200,348,34,3,385,0.9038961038961039,0.08831168831168831,0.007792207792207792
PVP01_0109400,902,141,30,1073,0.8406337371854613,0.13140726933830382,0.027958993476234855
PVP01_0109600,1140,68,53,1261,0.9040444091990484,0.05392545598731166,0.04203013481363997
PVP01_0109700,533,11,16,560,0.9517857142857142,0.019642857142857142,0.02857142857142857
PVP01_0109800,350,4,9,363,0.9641873278236914,0.011019283746556474,0.024793388429752067
PVP01_0109900,2203,255,82,2540,0.8673228346456693,0.10039370078740158,0.03228346456692913
PVP01_0110200,97,20,4,121,0.8016528925619835,0.1652892561983471,0.03305785123966942
PVP01_0110300,1782,30,835,2647,0.6732149603324519,0.011333585190782017,0.31545145447676615
PVP01_0110400,1452,49,620,2121,0.6845827439886846,0.0231023102310231,0.2923149457802923
PVP01_0110500,1250,40,94,1384,0.903179190751445,0.028901734104046242,0.06791907514450866
PVP01_0110700,45,11,0,56,0.8035714285714286,0.19642857142857142,0
PVP01_0110800,2834,608,80,3522,0.80465644520159,0.17262918796138557,0.022714366837024418
PVP01_0110900,386,23,8,417,0.9256594724220624,0.05515587529976019,0.019184652278177457
PVP01_0111000,7218,2975,233,10426,0.6923076923076923,0.2853443314789948,0.022347976213312873
PVP01_0111500,16,36,1,53,0.3018867924528302,0.6792452830188679,0.018867924528301886
PVP01_0111600,690,254,27,971,0.7106076210092688,0.2615859938208033,0.027806385169927908
PVP01_0111700,195,56,13,264,0.7386363636363636,0.21212121212121213,0.04924242424242424
PVP01_0111800,1418,346,122,1886,0.7518557794273595,0.18345705196182396,0.06468716861081654
PVP01_0111950,204,10,14,228,0.8947368421052632,0.043859649122807015,0.06140350877192982
PVP01_0112000,200,25,46,271,0.7380073800738007,0.09225092250922509,0.16974169741697417
PVP01_0112100,2017,79,70,2166,0.9312096029547553,0.03647276084949215,0.032317636195752536
PVP01_0112300,356,35,14,405,0.8790123456790123,0.08641975308641975,0.0345679012345679
PVP01_0112400,486,884,265,1635,0.29724770642201837,0.5406727828746177,0.1620795107033639
PVP01_0112500,1698,433,141,2272,0.7473591549295775,0.19058098591549297,0.06205985915492958
PVP01_0112600,2944,227,279,3450,0.8533333333333334,0.06579710144927536,0.0808695652173913
PVP01_0112900,3550,190,72,3812,0.9312696747114375,0.049842602308499476,0.01888772298006296
PVP01_0113000,11,0,2,13,0.8461538461538461,0,0.15384615384615385
PVP01_0113100,887,264,32,1183,0.7497886728655959,0.2231614539306847,0.027049873203719356
PVP01_0113200,621,28,166,815,0.7619631901840491,0.0343558282208589,0.20368098159509201
PVP01_0113300,807,469,205,1481,0.5449020931802836,0.31667792032410536,0.13841998649561107
PVP01_0113400,766,40,15,821,0.9330085261875761,0.048721071863580996,0.018270401948842874
PVP01_0113500,346,21,9,376,0.9202127659574468,0.05585106382978723,0.023936170212765957
PVP01_0113600,3734,569,1172,5475,0.6820091324200913,0.10392694063926941,0.21406392694063928
PVP01_0113900,442,14,419,875,0.5051428571428571,0.016,0.47885714285714287
PVP01_0114100,588,13,9,610,0.9639344262295082,0.021311475409836064,0.014754098360655738
PVP01_0114200,139,11,5,155,0.896774193548387,0.07096774193548387,0.03225806451612903
PVP01_0114300,385,9,35,429,0.8974358974358975,0.02097902097902098,0.08158508158508158
PVP01_0114500,1398,132,92,1622,0.8618988902589396,0.08138101109741061,0.05672009864364982
PVP01_0114600,930,35,26,991,0.9384460141271443,0.035317860746720484,0.026236125126135216
PVP01_0114700,1703,25,908,2636,0.6460546282245827,0.009484066767830045,0.34446130500758726
PVP01_0115000,530,21,96,647,0.8191653786707882,0.03245749613601236,0.14837712519319937
PVP01_0115100,218,12,7,237,0.919831223628692,0.05063291139240506,0.029535864978902954
PVP01_0115300,0,11,0,11,0,1,0
PVP01_0115400,34,5,7,46,0.7391304347826086,0.10869565217391304,0.15217391304347827
PVP01_0115600,98,0,8,106,0.9245283018867925,0,0.07547169811320754
PVP01_0115700,633,83,50,766,0.8263707571801566,0.10835509138381201,0.06527415143603134
PVP01_0115900,467,327,422,1216,0.3840460526315789,0.2689144736842105,0.3470394736842105
PVP01_0116100,2142,122,150,2414,0.8873239436619719,0.050538525269262634,0.06213753106876554
PVP01_0116200,128,113,8,249,0.5140562248995983,0.4538152610441767,0.0321285140562249
PVP01_0116300,2764,997,120,3881,0.7121875805204844,0.25689255346560164,0.03091986601391394
PVP01_0116400,1609,82,45,1736,0.9268433179723502,0.04723502304147465,0.025921658986175114
PVP01_0116500,90,7,4,101,0.8910891089108911,0.06930693069306931,0.039603960396039604
PVP01_0116700,816,196,1203,2215,0.36839729119638825,0.08848758465011286,0.5431151241534988
PVP01_0116800,629,8,18,655,0.9603053435114504,0.012213740458015267,0.02748091603053435
PVP01_0116900,636,21,627,1284,0.4953271028037383,0.016355140186915886,0.4883177570093458
PVP01_0117000,264,8,876,1148,0.22996515679442509,0.006968641114982578,0.7630662020905923
PVP01_0117200,1790,385,337,2512,0.7125796178343949,0.1532643312101911,0.13415605095541402
PVP01_0117300,265,40,112,417,0.6354916067146283,0.09592326139088729,0.2685851318944844
PVP01_0117400,147,2,5,154,0.9545454545454546,0.012987012987012988,0.032467532467532464
PVP01_0117500,27,3,0,30,0.9,0.1,0
PVP01_0117600,359,31,1253,1643,0.21850273889227023,0.018867924528301886,0.7626293365794279
PVP01_0117700,412,45,297,754,0.5464190981432361,0.05968169761273209,0.39389920424403185
PVP01_0117800,3286,3268,1782,8336,0.39419385796545103,0.3920345489443378,0.21377159309021113
PVP01_0117900,135,226,52,413,0.3268765133171913,0.5472154963680388,0.12590799031476999
PVP01_0118200,945,56,29,1030,0.9174757281553398,0.05436893203883495,0.02815533980582524
PVP01_0118400,1616,237,320,2173,0.7436723423838012,0.10906580763920846,0.14726184997699032
PVP01_0118500,435,74,76,585,0.7435897435897436,0.1264957264957265,0.12991452991452992
PVP01_0118600,774,27,26,827,0.9359129383313181,0.032648125755743655,0.03143893591293833
PVP01_0118700,355,701,227,1283,0.2766952455183164,0.5463756819953235,0.17692907248636008
PVP01_1134700,1024,129,24,1177,0.8700084961767205,0.10960067969413764,0.020390824129141887
PVP01_1134600,5478,3226,205,8909,0.6148838253451566,0.362105735772814,0.02301043888202941
PVP01_1134500,1259,59,187,1505,0.8365448504983388,0.03920265780730897,0.12425249169435217
PVP01_1134400,29,5,934,968,0.029958677685950414,0.005165289256198347,0.9648760330578512
PVP01_1134300,1100,128,288,1516,0.7255936675461742,0.08443271767810026,0.18997361477572558
PVP01_1134200,789,66,264,1119,0.7050938337801609,0.058981233243967826,0.2359249329758713
PVP01_1134100,148,57,11,216,0.6851851851851852,0.2638888888888889,0.05092592592592592
PVP01_1134000,140,2,2,144,0.9722222222222222,0.013888888888888888,0.013888888888888888
PVP01_1133900,114,5,9,128,0.890625,0.0390625,0.0703125
PVP01_1133800,386,12,29,427,0.9039812646370023,0.02810304449648712,0.06791569086651054
PVP01_1133600,158,5,16,179,0.88268156424581,0.027932960893854747,0.0893854748603352
PVP01_1133500,1225,199,95,1519,0.8064516129032258,0.13100724160631994,0.06254114549045425
PVP01_1133400,1053,494,42,1589,0.6626809314033983,0.3108873505349276,0.02643171806167401
PVP01_1133300,623,91,20,734,0.8487738419618529,0.12397820163487738,0.027247956403269755
PVP01_1133100,264,28,7,299,0.882943143812709,0.09364548494983277,0.023411371237458192
PVP01_1017900,764,148,17,929,0.8223896663078579,0.15931108719052745,0.01829924650161464
PVP01_1017800,3199,1682,95,4976,0.6428858520900321,0.3380225080385852,0.019091639871382637
PVP01_1017700,1263,822,68,2153,0.5866233163028333,0.3817928471899675,0.03158383650719926
PVP01_1017600,2359,132,62,2553,0.9240109674892284,0.05170387779083431,0.02428515471993733
PVP01_1017500,78,5,17,100,0.78,0.05,0.17
PVP01_1017300,1470,125,92,1687,0.8713692946058091,0.07409602845287493,0.054534676941315946
PVP01_1017000,9017,3966,359,13342,0.6758357067905861,0.29725678309099085,0.026907510118423024
PVP01_1016900,242,37,5,284,0.852112676056338,0.13028169014084506,0.017605633802816902
PVP01_1016800,29,2,7,38,0.7631578947368421,0.05263157894736842,0.18421052631578946
PVP01_1016600,5309,193,119,5621,0.9444938623020814,0.034335527486212415,0.021170610211706103
PVP01_1016500,212,29,6,247,0.8582995951417004,0.11740890688259109,0.024291497975708502
PVP01_1016400,114,8,61,183,0.6229508196721312,0.04371584699453552,0.3333333333333333
PVP01_1016300,5128,1812,212,7152,0.7170022371364653,0.2533557046979866,0.0296420581655481
PVP01_1016200,47,6,1,54,0.8703703703703703,0.1111111111111111,0.018518518518518517
PVP01_1015900,554,47,147,748,0.7406417112299465,0.06283422459893048,0.196524064171123
PVP01_1015700,623,15,22,660,0.943939393939394,0.022727272727272728,0.03333333333333333
PVP01_1015600,1054,69,44,1167,0.9031705227077977,0.05912596401028278,0.037703513281919454
PVP01_1015500,6,0,4,10,0.6,0,0.4
PVP01_1015400,3350,485,91,3926,0.8532857870606215,0.12353540499235864,0.023178807947019868
PVP01_1015300,1438,242,143,1823,0.7888096544157981,0.13274821722435545,0.0784421283598464
PVP01_1015200,48,11,25,84,0.5714285714285714,0.13095238095238096,0.2976190476190476
PVP01_1015100,35,5,9,49,0.7142857142857143,0.10204081632653061,0.1836734693877551
PVP01_1015000,2,0,4,6,0.3333333333333333,0,0.6666666666666666
PVP01_1014900,769,47,110,926,0.8304535637149028,0.05075593952483801,0.11879049676025918
PVP01_1014800,1039,28,27,1094,0.9497257769652651,0.025594149908592323,0.024680073126142597
PVP01_1014700,9359,892,1689,11940,0.7838358458961474,0.0747068676716918,0.1414572864321608
PVP01_1014600,1990,105,202,2297,0.8663474096647802,0.0457117979973879,0.08794079233783196
PVP01_1014500,4838,2774,166,7778,0.6220107996914374,0.35664695294420157,0.02134224736436102
PVP01_1014400,1976,277,334,2587,0.7638190954773869,0.10707383069192114,0.12910707383069192
PVP01_1014300,1127,49,22,1198,0.9407345575959933,0.040901502504173626,0.018363939899833055
PVP01_1014200,797,114,130,1041,0.765609990393852,0.10951008645533142,0.12487992315081652
PVP01_1014000,854,92,23,969,0.8813209494324046,0.09494324045407637,0.023735810113519093
PVP01_1013900,510,313,21,844,0.6042654028436019,0.3708530805687204,0.024881516587677725
PVP01_1013800,1141,169,80,1390,0.820863309352518,0.12158273381294964,0.05755395683453238
PVP01_1013700,1568,335,65,1968,0.7967479674796748,0.17022357723577236,0.033028455284552845
PVP01_1013600,792,107,20,919,0.8618063112078346,0.11643090315560392,0.02176278563656148
PVP01_1013500,642,12,26,680,0.9441176470588235,0.01764705882352941,0.03823529411764706
PVP01_1013300,686,45,25,756,0.9074074074074074,0.05952380952380952,0.03306878306878307
PVP01_1013200,832,172,342,1346,0.6181277860326895,0.1277860326894502,0.2540861812778603
PVP01_1013000,7209,1305,431,8945,0.8059250978200112,0.14589155953046395,0.048183342649524875
PVP01_1012800,105,4,9,118,0.8898305084745762,0.03389830508474576,0.07627118644067797
PVP01_1012700,283,15,40,338,0.8372781065088757,0.04437869822485207,0.11834319526627218
PVP01_1012500,2099,179,44,2322,0.9039621016365202,0.07708871662360034,0.018949181739879414
PVP01_1012300,5,0,0,5,1,0,0
PVP01_1012200,932,87,103,1122,0.8306595365418895,0.07754010695187166,0.09180035650623886
PVP01_1012100,2679,116,261,3056,0.8766361256544503,0.03795811518324607,0.08540575916230367
PVP01_1011900,925,113,38,1076,0.8596654275092936,0.1050185873605948,0.03531598513011153
PVP01_1011800,158,8,574,740,0.21351351351351353,0.010810810810810811,0.7756756756756756
PVP01_1011700,353,154,287,794,0.4445843828715365,0.19395465994962216,0.3614609571788413
PVP01_1011600,500,415,591,1506,0.33200531208499334,0.27556440903054447,0.39243027888446214
PVP01_1011300,32,0,67,99,0.32323232323232326,0,0.6767676767676768
PVP01_1011100,327,66,11,404,0.8094059405940595,0.16336633663366337,0.027227722772277228
PVP01_1010800,1538,94,36,1668,0.9220623501199041,0.05635491606714628,0.02158273381294964
PVP01_1010700,174,13,4,191,0.9109947643979057,0.06806282722513089,0.020942408376963352
PVP01_1010600,38,1,11,50,0.76,0.02,0.22
PVP01_1010400,4,0,0,4,1,0,0
PVP01_1010300,626,12,36,674,0.9287833827893175,0.017804154302670624,0.05341246290801187
PVP01_1010200,402,51,12,465,0.864516129032258,0.10967741935483871,0.025806451612903226
PVP01_1010100,5,0,3,8,0.625,0,0.375
PVP01_1010000,1030,213,16,1259,0.818109610802224,0.1691818903891978,0.012708498808578236
PVP01_1009700,48,1,11,60,0.8,0.016666666666666666,0.18333333333333332
PVP01_1009600,326,161,10,497,0.6559356136820925,0.323943661971831,0.02012072434607646
PVP01_1009500,11,8,1,20,0.55,0.4,0.05
PVP01_1009400,14,6,1,21,0.6666666666666666,0.2857142857142857,0.047619047619047616
PVP01_1009200,157,34,8,199,0.7889447236180904,0.1708542713567839,0.04020100502512563
PVP01_1009100,266,24,44,334,0.7964071856287425,0.0718562874251497,0.1317365269461078
PVP01_1008900,1228,701,90,2019,0.6082218920257553,0.3472015849430411,0.04457652303120357
PVP01_1008800,231,82,15,328,0.7042682926829268,0.25,0.04573170731707317
PVP01_1008600,4218,130,862,5210,0.8095969289827255,0.02495201535508637,0.1654510556621881
PVP01_1008400,1692,82,522,2296,0.7369337979094077,0.03571428571428571,0.2273519163763066
PVP01_1008300,629,246,25,900,0.6988888888888889,0.2733333333333333,0.027777777777777776
PVP01_1008200,131,6,6,143,0.916083916083916,0.04195804195804196,0.04195804195804196
PVP01_1008100,50,4,2,56,0.8928571428571429,0.07142857142857142,0.03571428571428571
PVP01_1008000,179,482,12456,13117,0.013646413051764885,0.03674620721201494,0.9496073797362202
PVP01_1007800,718,205,21,944,0.760593220338983,0.21716101694915255,0.022245762711864406
PVP01_1007700,134,31,1,166,0.8072289156626506,0.18674698795180722,0.006024096385542169
PVP01_1007600,578,32,15,625,0.9248,0.0512,0.024
PVP01_1007500,761,17,62,840,0.905952380952381,0.02023809523809524,0.07380952380952381
PVP01_1007400,399,13,17,429,0.9300699300699301,0.030303030303030304,0.039627039627039624
PVP01_1007300,3470,255,1437,5162,0.6722200697404107,0.04939945757458349,0.2783804726850058
PVP01_1007100,3034,369,454,3857,0.7866217267306197,0.09567021000777806,0.11770806326160228
PVP01_1007000,420,44,6,470,0.8936170212765957,0.09361702127659574,0.01276595744680851
PVP01_1006900,606,36,14,656,0.9237804878048781,0.054878048780487805,0.021341463414634148
PVP01_1006800,656,11,82,749,0.8758344459279038,0.014686248331108143,0.10947930574098798
PVP01_1006700,200,11,7,218,0.9174311926605505,0.05045871559633028,0.03211009174311927
PVP01_1006600,2344,77,121,2542,0.9221085759244689,0.03029110936270653,0.04760031471282455
PVP01_1006500,83,32,9,124,0.6693548387096774,0.25806451612903225,0.07258064516129033
PVP01_1006300,9780,2988,361,13129,0.7449158351740423,0.22758778277096503,0.027496382054992764
PVP01_1006200,493,6,10,509,0.9685658153241651,0.011787819253438114,0.019646365422396856
PVP01_1005900,2913,1009,102,4024,0.7239065606361829,0.2507455268389662,0.025347912524850896
PVP01_1005800,982,82,30,1094,0.8976234003656307,0.07495429616087751,0.027422303473491772
PVP01_1005700,256,41,15,312,0.8205128205128205,0.13141025641025642,0.04807692307692308
PVP01_1005600,1252,477,43,1772,0.7065462753950339,0.26918735891647855,0.024266365688487584
PVP01_1005500,10,5,741,756,0.013227513227513227,0.006613756613756613,0.9801587301587301
PVP01_1005300,14,0,1,15,0.9333333333333333,0,0.06666666666666667
PVP01_1005200,695,434,46,1175,0.5914893617021276,0.36936170212765956,0.03914893617021276
PVP01_1005100,64,11,0,75,0.8533333333333334,0.14666666666666667,0
PVP01_1005000,843,1007,161,2011,0.4191944306315266,0.5007458975634013,0.0800596718050721
PVP01_1004900,72,3,7,82,0.8780487804878049,0.036585365853658534,0.08536585365853659
PVP01_1004800,16,3,0,19,0.8421052631578947,0.15789473684210525,0
PVP01_1004700,990,85,24,1099,0.9008189262966333,0.07734303912647862,0.02183803457688808
PVP01_1004600,534,50,7,591,0.9035532994923858,0.08460236886632826,0.011844331641285956
PVP01_1004400,95,8,3,106,0.8962264150943396,0.07547169811320754,0.02830188679245283
PVP01_1004200,528,113,17,658,0.8024316109422492,0.1717325227963526,0.025835866261398176
PVP01_1004100,1803,67,212,2082,0.8659942363112392,0.03218059558117195,0.10182516810758886
PVP01_1004000,12,1,3,16,0.75,0.0625,0.1875
PVP01_1003800,47,8,12,67,0.7014925373134329,0.11940298507462686,0.1791044776119403
PVP01_1003500,596,62,25,683,0.8726207906295754,0.09077598828696926,0.036603221083455345
PVP01_1003400,96,8,3,107,0.897196261682243,0.07476635514018691,0.028037383177570093
PVP01_1003300,858,202,29,1089,0.7878787878787878,0.1854912764003673,0.02662993572084481
PVP01_1003200,556,133,27,716,0.776536312849162,0.1857541899441341,0.03770949720670391
PVP01_1003100,148,2,6,156,0.9487179487179487,0.01282051282051282,0.038461538461538464
PVP01_1003000,245,4,8,257,0.953307392996109,0.01556420233463035,0.0311284046692607
PVP01_1002900,554,71,314,939,0.5899893503727369,0.07561235356762513,0.3343982960596379
PVP01_1002800,2409,212,416,3037,0.793216990451103,0.06980572933816266,0.13697728021073427
PVP01_1002600,127,8,4,139,0.9136690647482014,0.05755395683453238,0.02877697841726619
PVP01_1002500,1064,166,30,1260,0.8444444444444444,0.13174603174603175,0.023809523809523808
PVP01_1002400,146,96,66,308,0.474025974025974,0.3116883116883117,0.21428571428571427
PVP01_1270600,5,2,0,7,0.7142857142857143,0.2857142857142857,0
PVP01_1270500,1272,210,201,1683,0.7557932263814616,0.12477718360071301,0.11942959001782531
PVP01_1270400,56,6,5,67,0.835820895522388,0.08955223880597014,0.07462686567164178
PVP01_1270200,26,1,1,28,0.9285714285714286,0.03571428571428571,0.03571428571428571
PVP01_1270100,2313,252,75,2640,0.8761363636363636,0.09545454545454546,0.028409090909090908
PVP01_1270000,1317,100,38,1455,0.9051546391752577,0.06872852233676977,0.02611683848797251
PVP01_1269900,500,38,14,552,0.9057971014492754,0.06884057971014493,0.025362318840579712
PVP01_1269800,540,21,14,575,0.9391304347826087,0.036521739130434785,0.02434782608695652
PVP01_1269700,1473,114,27,1614,0.912639405204461,0.07063197026022305,0.016728624535315983
PVP01_1269600,683,40,12,735,0.9292517006802721,0.05442176870748299,0.0163265306122449
PVP01_1269500,94,35,68,197,0.47715736040609136,0.17766497461928935,0.34517766497461927
PVP01_1269400,2643,700,1443,4786,0.5522356874216464,0.14625992478061012,0.3015043877977434
PVP01_1269300,392,9,8,409,0.9584352078239609,0.022004889975550123,0.019559902200488997
PVP01_1269000,22,1,2,25,0.88,0.04,0.08
PVP01_1268900,265,27,7,299,0.8862876254180602,0.0903010033444816,0.023411371237458192
PVP01_1268500,232,84,9,325,0.7138461538461538,0.25846153846153846,0.027692307692307693
PVP01_1268400,427,120,22,569,0.7504393673110721,0.210896309314587,0.03866432337434095
PVP01_1268300,1196,17,26,1239,0.9652945924132365,0.013720742534301856,0.020984665052461663
PVP01_1268200,53,10,15,78,0.6794871794871795,0.1282051282051282,0.19230769230769232
PVP01_1268000,140,3,6,149,0.9395973154362416,0.020134228187919462,0.040268456375838924
PVP01_1267800,30,4,0,34,0.8823529411764706,0.11764705882352941,0
PVP01_1267700,803,214,45,1062,0.756120527306968,0.2015065913370998,0.0423728813559322
PVP01_1267600,592,22,217,831,0.7123947051744886,0.026474127557160047,0.2611311672683514
PVP01_1267500,146,3,242,391,0.3734015345268542,0.0076726342710997444,0.618925831202046
PVP01_1267400,75,2,29,106,0.7075471698113207,0.018867924528301886,0.27358490566037735
PVP01_1267300,798,36,23,857,0.9311551925320887,0.042007001166861145,0.026837806301050177
PVP01_1267200,216,44,9,269,0.8029739776951673,0.16356877323420074,0.03345724907063197
PVP01_1267100,2614,487,101,3202,0.816364772017489,0.15209244222361024,0.03154278575890069
PVP01_1266900,513,11,396,920,0.5576086956521739,0.011956521739130435,0.43043478260869567
PVP01_1266800,68,5,106,179,0.37988826815642457,0.027932960893854747,0.5921787709497207
PVP01_1266700,158,35,39,232,0.6810344827586207,0.15086206896551724,0.16810344827586207
PVP01_1266400,29,2,3,34,0.8529411764705882,0.058823529411764705,0.08823529411764706
PVP01_1266300,107,22,1,130,0.823076923076923,0.16923076923076924,0.007692307692307693
PVP01_1266200,73,2,13,88,0.8295454545454546,0.022727272727272728,0.14772727272727273
PVP01_1266100,406,5,128,539,0.7532467532467533,0.00927643784786642,0.23747680890538034
PVP01_1266000,479,151,11,641,0.7472698907956318,0.23556942277691106,0.0171606864274571
PVP01_1265800,3078,1393,97,4568,0.6738178633975481,0.3049474605954466,0.021234676007005255
PVP01_1265700,483,35,747,1265,0.38181818181818183,0.02766798418972332,0.5905138339920949
PVP01_1265600,1171,56,38,1265,0.9256916996047431,0.04426877470355731,0.030039525691699605
PVP01_1265500,262,4,10,276,0.9492753623188406,0.014492753623188406,0.036231884057971016
PVP01_1265400,49,1,114,164,0.29878048780487804,0.006097560975609756,0.6951219512195121
PVP01_1265300,890,36,56,982,0.9063136456211812,0.03665987780040733,0.05702647657841141
PVP01_1265100,119,7,7,133,0.8947368421052632,0.05263157894736842,0.05263157894736842
PVP01_1265000,216,13,6,235,0.9191489361702128,0.05531914893617021,0.02553191489361702
PVP01_1264900,351,12,12,375,0.936,0.032,0.032
PVP01_1264700,1832,434,47,2313,0.7920449632511889,0.18763510592304367,0.020319930825767402
PVP01_1264500,1253,88,29,1370,0.9145985401459854,0.06423357664233577,0.021167883211678833
PVP01_1264200,259,15,6,280,0.925,0.05357142857142857,0.02142857142857143
PVP01_1264000,930,9,35,974,0.9548254620123203,0.009240246406570842,0.03593429158110883
PVP01_1263800,78,9,9,96,0.8125,0.09375,0.09375
PVP01_1263700,1131,173,30,1334,0.8478260869565217,0.12968515742128936,0.022488755622188907
PVP01_1263600,2394,83,81,2558,0.9358874120406567,0.03244722439405786,0.031665363565285376
PVP01_1263500,597,81,11,689,0.8664731494920174,0.11756168359941944,0.015965166908563134
PVP01_1263300,41,0,6,47,0.8723404255319149,0,0.1276595744680851
PVP01_1263200,1831,204,194,2229,0.8214445939883356,0.09152086137281291,0.0870345446388515
PVP01_1263100,1699,173,68,1940,0.8757731958762887,0.08917525773195877,0.03505154639175258
PVP01_1263000,1,0,0,1,1,0,0
PVP01_1262900,1059,45,350,1454,0.7283356258596974,0.030949105914718018,0.2407152682255846
PVP01_1262800,9,1,15,25,0.36,0.04,0.6
PVP01_1262700,3067,182,182,3431,0.8939084814922763,0.053045759253861846,0.053045759253861846
PVP01_1262600,126,39,5,170,0.7411764705882353,0.22941176470588234,0.029411764705882353
PVP01_1262300,229,7,16,252,0.9087301587301587,0.027777777777777776,0.06349206349206349
PVP01_1262200,2251,800,55,3106,0.7247263361236317,0.25756600128783,0.017707662588538314
PVP01_1262000,382,16,29,427,0.8946135831381733,0.03747072599531616,0.06791569086651054
PVP01_1261800,916,793,327,2036,0.449901768172888,0.3894891944990177,0.1606090373280943
PVP01_1261700,95,11,0,106,0.8962264150943396,0.10377358490566038,0
PVP01_1261600,949,1408,1382,3739,0.25381117945974857,0.376571275742177,0.36961754479807435
PVP01_1261500,92,78,161,331,0.27794561933534745,0.23564954682779457,0.486404833836858
PVP01_1261400,478,252,212,942,0.5074309978768577,0.267515923566879,0.22505307855626328
PVP01_1261300,2579,1082,71,3732,0.6910503751339764,0.289924973204716,0.01902465166130761
PVP01_1261200,147,15,8,170,0.8647058823529412,0.08823529411764706,0.047058823529411764
PVP01_1260900,32,2,312,346,0.09248554913294797,0.005780346820809248,0.9017341040462428
PVP01_1260800,2762,365,151,3278,0.8425869432580841,0.1113483831604637,0.0460646735814521
PVP01_1260600,150,2,4,156,0.9615384615384616,0.01282051282051282,0.02564102564102564
PVP01_1260300,1394,40,781,2215,0.6293453724604966,0.01805869074492099,0.3525959367945824
PVP01_1260200,72,6,7,85,0.8470588235294118,0.07058823529411765,0.08235294117647059
PVP01_1260100,82,9,2,93,0.8817204301075269,0.0967741935483871,0.021505376344086023
PVP01_1260000,1787,920,87,2794,0.6395848246241947,0.329277022190408,0.03113815318539728
PVP01_1259900,68,37,15,120,0.5666666666666667,0.30833333333333335,0.125
PVP01_1259800,1577,336,184,2097,0.7520267048164044,0.16022889842632332,0.08774439675727229
PVP01_1259700,61,3,2,66,0.9242424242424242,0.045454545454545456,0.030303030303030304
PVP01_1259600,61,8,2,71,0.8591549295774648,0.11267605633802817,0.028169014084507043
PVP01_1259500,3,2,0,5,0.6,0.4,0
PVP01_1259400,7,1,0,8,0.875,0.125,0
PVP01_1259300,209,6,7,222,0.9414414414414415,0.02702702702702703,0.03153153153153153
PVP01_1259200,460,539,131,1130,0.40707964601769914,0.47699115044247786,0.11592920353982301
PVP01_1259100,771,95,503,1369,0.5631848064280497,0.06939371804236669,0.36742147552958365
PVP01_1259000,192,165,21,378,0.5079365079365079,0.4365079365079365,0.05555555555555555
PVP01_1258800,103,0,12,115,0.8956521739130435,0,0.10434782608695652
PVP01_1258600,1928,336,35,2299,0.8386254893431927,0.14615050021748585,0.015224010439321443
PVP01_1258400,832,97,216,1145,0.7266375545851529,0.08471615720524017,0.188646288209607
PVP01_1258300,545,104,152,801,0.6803995006242197,0.12983770287141075,0.18976279650436953
PVP01_1258200,1042,42,58,1142,0.9124343257443083,0.03677758318739054,0.050788091068301226
PVP01_1258100,20,0,1,21,0.9523809523809523,0,0.047619047619047616
PVP01_1258000,13,3,0,16,0.8125,0.1875,0
PVP01_1257900,442,22,1635,2099,0.21057646498332538,0.010481181515007145,0.7789423535016674
PVP01_1257700,265,260,20,545,0.48623853211009177,0.47706422018348627,0.03669724770642202
PVP01_1257600,1447,15,50,1512,0.957010582010582,0.00992063492063492,0.03306878306878307
PVP01_1257400,197,2,377,576,0.3420138888888889,0.003472222222222222,0.6545138888888888
PVP01_1257300,242,262,73,577,0.4194107452339688,0.4540727902946274,0.1265164644714038
PVP01_1257200,49,24,27,100,0.49,0.24,0.27
PVP01_1257100,1421,70,220,1711,0.8305084745762712,0.040911747516072475,0.12857977790765635
PVP01_1257000,41,6,87,134,0.30597014925373134,0.04477611940298507,0.6492537313432836
PVP01_1256900,454,84,13,551,0.8239564428312159,0.15245009074410162,0.023593466424682397
PVP01_1256800,13,4,0,17,0.7647058823529411,0.23529411764705882,0
PVP01_1256600,289,191,18,498,0.5803212851405622,0.38353413654618473,0.03614457831325301
PVP01_1256500,1292,54,79,1425,0.9066666666666666,0.037894736842105266,0.05543859649122807
PVP01_1256300,3271,1270,519,5060,0.6464426877470356,0.2509881422924901,0.10256916996047431
PVP01_1256200,244,32,10,286,0.8531468531468531,0.11188811188811189,0.03496503496503497
PVP01_1256100,570,68,11,649,0.8782742681047766,0.10477657935285054,0.01694915254237288
PVP01_1255700,759,11,80,850,0.8929411764705882,0.012941176470588235,0.09411764705882353
PVP01_1255600,2250,154,250,2654,0.8477769404672193,0.058025621703089676,0.09419743782969103
PVP01_1255500,744,117,34,895,0.8312849162011173,0.13072625698324022,0.03798882681564246
PVP01_1255300,106,3,48,157,0.6751592356687898,0.01910828025477707,0.3057324840764331
PVP01_1255200,2502,274,132,2908,0.8603851444291609,0.09422283356258597,0.0453920220082531
PVP01_1255100,373,394,61,828,0.4504830917874396,0.4758454106280193,0.07367149758454106
PVP01_1255000,208,28,2775,3011,0.06908003985386915,0.009299236134174693,0.9216207240119562
PVP01_1254900,25,9,1,35,0.7142857142857143,0.2571428571428571,0.02857142857142857
PVP01_1254800,190,21,5,216,0.8796296296296297,0.09722222222222222,0.023148148148148147
PVP01_1254700,1867,255,65,2187,0.8536808413351623,0.11659807956104253,0.029721079103795154
PVP01_1254500,368,17,86,471,0.7813163481953291,0.036093418259023353,0.18259023354564755
PVP01_1254300,2736,405,66,3207,0.8531337698783911,0.12628624883068287,0.0205799812909261
PVP01_1254200,9,1,4,14,0.6428571428571429,0.07142857142857142,0.2857142857142857
PVP01_1254100,602,44,39,685,0.8788321167883212,0.06423357664233577,0.05693430656934306
PVP01_1254000,1415,285,46,1746,0.8104238258877434,0.16323024054982818,0.026345933562428408
PVP01_1253800,1118,21,124,1263,0.885193982581156,0.0166270783847981,0.09817893903404593
PVP01_1253700,2,0,0,2,1,0,0
PVP01_1253600,1585,128,180,1893,0.8372952984680402,0.0676175382989963,0.09508716323296355
PVP01_1253500,51,5,4,60,0.85,0.08333333333333333,0.06666666666666667
PVP01_1253400,454,78,7,539,0.8423005565862709,0.14471243042671614,0.012987012987012988
PVP01_1253300,4431,991,123,5545,0.7990982867448152,0.1787195671776375,0.02218214607754734
PVP01_1253200,675,97,58,830,0.8132530120481928,0.11686746987951807,0.06987951807228916
PVP01_1253000,1418,188,74,1680,0.844047619047619,0.11190476190476191,0.04404761904761905
PVP01_1252900,319,39,18,376,0.848404255319149,0.10372340425531915,0.047872340425531915
PVP01_1252800,369,274,18,661,0.5582450832072617,0.4145234493192133,0.02723146747352496
PVP01_1252600,2812,1040,88,3940,0.7137055837563452,0.2639593908629442,0.02233502538071066
PVP01_1252500,42,6,1,49,0.8571428571428571,0.12244897959183673,0.02040816326530612
PVP01_1252400,546,65,28,639,0.8544600938967136,0.10172143974960876,0.04381846635367762
PVP01_1252300,2398,324,70,2792,0.8588825214899714,0.11604584527220631,0.025071633237822348
PVP01_1252200,1,1,0,2,0.5,0.5,0
PVP01_1252100,1,1,0,2,0.5,0.5,0
PVP01_1252000,8,0,7,15,0.5333333333333333,0,0.4666666666666667
PVP01_1251800,18,0,2,20,0.9,0,0.1
PVP01_1251600,41,136,2778,2955,0.013874788494077835,0.046023688663282575,0.9401015228426396
PVP01_1251500,49,6,1,56,0.875,0.10714285714285714,0.017857142857142856
PVP01_1251400,509,21,22,552,0.9221014492753623,0.03804347826086957,0.03985507246376811
PVP01_1251300,617,10,182,809,0.7626699629171817,0.012360939431396786,0.2249690976514215
PVP01_1251100,50,2,8,60,0.8333333333333334,0.03333333333333333,0.13333333333333333
PVP01_1251000,644,12,34,690,0.9333333333333333,0.017391304347826087,0.04927536231884058
PVP01_1250800,60,8,3,71,0.8450704225352113,0.11267605633802817,0.04225352112676056
PVP01_1250700,750,183,18,951,0.7886435331230284,0.19242902208201892,0.01892744479495268
PVP01_1250600,867,34,510,1411,0.6144578313253012,0.024096385542168676,0.3614457831325301
PVP01_1250300,712,48,20,780,0.9128205128205128,0.06153846153846154,0.02564102564102564
PVP01_1250200,365,28,45,438,0.8333333333333334,0.0639269406392694,0.10273972602739725
PVP01_1250000,109,102,4,215,0.5069767441860465,0.4744186046511628,0.018604651162790697
PVP01_1249900,1184,79,212,1475,0.8027118644067797,0.05355932203389831,0.14372881355932204
PVP01_1249700,1779,124,26,1929,0.9222395023328149,0.064282011404873,0.01347848626231208
PVP01_1249600,1698,1058,56,2812,0.6038406827880513,0.3762446657183499,0.01991465149359886
PVP01_1249400,1287,100,183,1570,0.8197452229299363,0.06369426751592357,0.11656050955414013
PVP01_1249300,1713,236,187,2136,0.8019662921348315,0.1104868913857678,0.08754681647940075
PVP01_1249200,1648,3167,166,4981,0.3308572575787994,0.6358161011845012,0.033326641236699456
PVP01_1248800,79,2,3,84,0.9404761904761905,0.023809523809523808,0.03571428571428571
PVP01_1248700,196,7,1,204,0.9607843137254902,0.03431372549019608,0.004901960784313725
PVP01_1248600,495,14,183,692,0.7153179190751445,0.02023121387283237,0.26445086705202314
PVP01_1248500,412,9,8,429,0.9603729603729604,0.02097902097902098,0.018648018648018648
PVP01_1248400,620,10,32,662,0.9365558912386707,0.015105740181268883,0.04833836858006042
PVP01_1248300,183,42,43,268,0.6828358208955224,0.15671641791044777,0.16044776119402984
PVP01_1248200,1718,34,67,1819,0.9444749862561848,0.018691588785046728,0.036833424958768554
PVP01_1248100,860,332,156,1348,0.6379821958456974,0.24629080118694363,0.11572700296735905
PVP01_1248000,61,5,9,75,0.8133333333333334,0.06666666666666667,0.12
PVP01_1247900,1061,803,44,1908,0.5560796645702306,0.42085953878406707,0.023060796645702306
PVP01_1247600,277,11,207,495,0.5595959595959596,0.022222222222222223,0.41818181818181815
PVP01_1247500,55,56,3,114,0.4824561403508772,0.49122807017543857,0.02631578947368421
PVP01_1247400,208,191,13,412,0.5048543689320388,0.46359223300970875,0.03155339805825243
PVP01_1247300,910,51,32,993,0.9164149043303121,0.0513595166163142,0.032225579053373615
PVP01_1247200,141,3,21,165,0.8545454545454545,0.01818181818181818,0.12727272727272726
PVP01_1247100,529,80,68,677,0.7813884785819794,0.11816838995568685,0.10044313146233383
PVP01_1247000,3,0,203,206,0.014563106796116505,0,0.9854368932038835
PVP01_1246800,989,637,64,1690,0.585207100591716,0.3769230769230769,0.0378698224852071
PVP01_1246600,305,19,15,339,0.8997050147492626,0.05604719764011799,0.04424778761061947
PVP01_1246500,6280,1795,191,8266,0.7597386886039197,0.21715460924268087,0.023106702153399467
PVP01_1246400,279,21,6,306,0.9117647058823529,0.06862745098039216,0.0196078431372549
PVP01_1246200,52,4,138,194,0.26804123711340205,0.020618556701030927,0.711340206185567
PVP01_1246100,3975,2797,211,6983,0.5692395818416154,0.40054417871974796,0.03021623943863669
PVP01_1246000,478,30,23,531,0.9001883239171374,0.05649717514124294,0.04331450094161959
PVP01_1245800,194,8,2,204,0.9509803921568627,0.0392156862745098,0.00980392156862745
PVP01_1245600,39,59,3,101,0.38613861386138615,0.5841584158415841,0.0297029702970297
PVP01_1245500,380,202,44,626,0.6070287539936102,0.3226837060702875,0.07028753993610223
PVP01_1245400,21,3,165,189,0.1111111111111111,0.015873015873015872,0.873015873015873
PVP01_1245300,4,1,3,8,0.5,0.125,0.375
PVP01_1245200,1566,387,47,2000,0.783,0.1935,0.0235
PVP01_1245100,7,2,1,10,0.7,0.2,0.1
PVP01_1244900,2181,418,47,2646,0.8242630385487528,0.15797430083144368,0.017762660619803475
PVP01_1244800,0,0,0,0,NaN,NaN,NaN
PVP01_1244700,204,11,20,235,0.8680851063829788,0.04680851063829787,0.0851063829787234
PVP01_1244600,329,43,33,405,0.8123456790123457,0.10617283950617284,0.08148148148148149
PVP01_1244500,3474,553,186,4213,0.8245905530500831,0.13126038452409208,0.04414906242582483
PVP01_1244300,271,20,11,302,0.8973509933774835,0.06622516556291391,0.03642384105960265
PVP01_1244200,3,2,0,5,0.6,0.4,0
PVP01_1244100,1194,27,175,1396,0.8553008595988538,0.019340974212034383,0.12535816618911175
PVP01_1244000,1819,378,52,2249,0.8088039128501556,0.1680746998666074,0.023121387283236993
PVP01_1243800,585,397,52,1034,0.5657640232108317,0.3839458413926499,0.05029013539651837
PVP01_1243500,263,6,8,277,0.9494584837545126,0.021660649819494584,0.02888086642599278
PVP01_1243400,1771,701,62,2534,0.6988950276243094,0.27663772691397,0.0244672454617206
PVP01_1243100,536,15,22,573,0.9354275741710296,0.02617801047120419,0.038394415357766144
PVP01_1243200,40,1,2,43,0.9302325581395349,0.023255813953488372,0.046511627906976744
PVP01_1242900,118,9,1551,1678,0.07032181168057211,0.005363528009535161,0.9243146603098927
PVP01_1242800,2941,278,72,3291,0.8936493467031298,0.08447280461865694,0.02187784867821331
PVP01_1242600,249,104,13,366,0.680327868852459,0.28415300546448086,0.03551912568306011
PVP01_1242400,48,21,2,71,0.676056338028169,0.29577464788732394,0.028169014084507043
PVP01_1242200,774,308,605,1687,0.4588026081802015,0.1825726141078838,0.35862477771191464
PVP01_1242100,881,62,256,1199,0.7347789824854045,0.05170975813177648,0.213511259382819
PVP01_1242000,4,0,0,4,1,0,0
PVP01_1241900,359,101,15,475,0.7557894736842106,0.21263157894736842,0.031578947368421054
PVP01_1241800,568,18,225,811,0.7003699136868065,0.02219482120838471,0.27743526510480887
PVP01_1241600,466,28,22,516,0.9031007751937985,0.05426356589147287,0.04263565891472868
PVP01_1241400,133,54,76,263,0.5057034220532319,0.20532319391634982,0.2889733840304182
PVP01_1241300,107,2,2,111,0.963963963963964,0.018018018018018018,0.018018018018018018
PVP01_1241200,32,2,2,36,0.8888888888888888,0.05555555555555555,0.05555555555555555
PVP01_1241100,55,2,4,61,0.9016393442622951,0.03278688524590164,0.06557377049180328
PVP01_1240900,2902,1599,86,4587,0.6326575103553521,0.3485938521909745,0.018748637453673424
PVP01_1240800,75,11,5,91,0.8241758241758241,0.12087912087912088,0.054945054945054944
PVP01_1240700,968,14,156,1138,0.8506151142355008,0.012302284710017574,0.13708260105448156
PVP01_1240500,3954,367,157,4478,0.8829834747655203,0.0819562304600268,0.03506029477445288
PVP01_1240300,33,3,4,40,0.825,0.075,0.1
PVP01_1240200,15,7,1,23,0.6521739130434783,0.30434782608695654,0.043478260869565216
PVP01_1240100,29,50,0,79,0.3670886075949367,0.6329113924050633,0
PVP01_1240000,575,948,494,2017,0.2850768468021815,0.47000495785820523,0.2449181953396133
PVP01_1239700,237,23,2,262,0.9045801526717557,0.08778625954198473,0.007633587786259542
PVP01_1239600,455,89,12,556,0.8183453237410072,0.16007194244604317,0.02158273381294964
PVP01_1239500,1530,59,51,1640,0.9329268292682927,0.03597560975609756,0.031097560975609756
PVP01_1239400,2010,101,42,2153,0.9335810496980956,0.046911286576869486,0.019507663725034836
PVP01_1239300,2604,252,68,2924,0.8905608755129959,0.08618331053351573,0.023255813953488372
PVP01_1239100,174,20,21,215,0.8093023255813954,0.09302325581395349,0.09767441860465116
PVP01_1239000,394,8,16,418,0.9425837320574163,0.019138755980861243,0.03827751196172249
PVP01_1238900,2195,90,476,2761,0.7950018109380659,0.03259688518652662,0.17240130387540747
PVP01_1238800,196,8,60,264,0.7424242424242424,0.030303030303030304,0.22727272727272727
PVP01_1238700,1868,336,807,3011,0.6203918963799402,0.11159083361009631,0.26801727000996345
PVP01_1238600,347,74,13,434,0.7995391705069125,0.17050691244239632,0.029953917050691243
PVP01_1238500,38,0,7,45,0.8444444444444444,0,0.15555555555555556
PVP01_1238300,55,2,3,60,0.9166666666666666,0.03333333333333333,0.05
PVP01_1238100,1112,835,35,1982,0.5610494450050454,0.42129162462159436,0.017658930373360242
PVP01_1238000,2803,821,362,3986,0.7032112393376819,0.20597089814350225,0.09081786251881585
PVP01_1237900,535,124,35,694,0.770893371757925,0.1786743515850144,0.05043227665706052
PVP01_1237800,910,117,25,1052,0.8650190114068441,0.1112167300380228,0.02376425855513308
PVP01_1237700,727,100,21,848,0.8573113207547169,0.1179245283018868,0.024764150943396228
PVP01_1237500,542,613,75,1230,0.44065040650406506,0.4983739837398374,0.06097560975609756
PVP01_1237300,3951,517,224,4692,0.842071611253197,0.11018755328218244,0.04774083546462063
PVP01_1237200,268,12,64,344,0.7790697674418605,0.03488372093023256,0.18604651162790697
PVP01_1237100,1494,38,120,1652,0.9043583535108959,0.023002421307506054,0.07263922518159806
PVP01_1237000,281,7,6,294,0.95578231292517,0.023809523809523808,0.02040816326530612
PVP01_1236900,23,6,4,33,0.696969696969697,0.18181818181818182,0.12121212121212122
PVP01_1236800,85,0,2,87,0.9770114942528736,0,0.022988505747126436
PVP01_1236600,842,690,362,1894,0.44456177402323127,0.36430834213305174,0.191129883843717
PVP01_1236500,790,499,215,1504,0.5252659574468085,0.331781914893617,0.14295212765957446
PVP01_1236400,594,7,75,676,0.878698224852071,0.010355029585798817,0.11094674556213018
PVP01_1236300,35,8,3,46,0.7608695652173914,0.17391304347826086,0.06521739130434782
PVP01_1236200,2161,859,243,3263,0.6622739809990806,0.26325467361323934,0.07447134538768005
PVP01_1236000,1643,174,51,1868,0.8795503211991434,0.09314775160599571,0.027301927194860815
PVP01_1235900,1442,62,51,1555,0.9273311897106109,0.03987138263665595,0.03279742765273312
PVP01_1235800,235,450,33,718,0.32729805013927576,0.6267409470752089,0.04596100278551532
PVP01_1235700,5488,5889,616,11993,0.45760026682231303,0.49103643792212126,0.051363295255565745
PVP01_1235600,116,17,20,153,0.7581699346405228,0.1111111111111111,0.13071895424836602
PVP01_1235500,25,5,1,31,0.8064516129032258,0.16129032258064516,0.03225806451612903
PVP01_1235400,730,543,701,1974,0.3698074974670719,0.2750759878419453,0.35511651469098277
PVP01_1235300,63,0,4,67,0.9402985074626866,0,0.05970149253731343
PVP01_1234800,84,23,2,109,0.7706422018348624,0.21100917431192662,0.01834862385321101
PVP01_1234700,60,10,7,77,0.7792207792207793,0.12987012987012986,0.09090909090909091
PVP01_1234600,511,258,53,822,0.621654501216545,0.31386861313868614,0.06447688564476886
PVP01_1234500,495,79,259,833,0.5942376950780313,0.09483793517406963,0.31092436974789917
PVP01_1234400,575,28,25,628,0.9156050955414012,0.044585987261146494,0.03980891719745223
PVP01_1234300,17,2,5,24,0.7083333333333334,0.08333333333333333,0.20833333333333334
PVP01_1234200,592,13,65,670,0.8835820895522388,0.019402985074626865,0.09701492537313433
PVP01_1234100,3085,93,95,3273,0.9425603421937061,0.02841429880843263,0.029025358997861288
PVP01_1234000,1069,55,43,1167,0.9160239931448158,0.04712939160239932,0.03684661525278492
PVP01_1233900,284,27,7,318,0.8930817610062893,0.08490566037735849,0.0220125786163522
PVP01_1233800,2,1,0,3,0.6666666666666666,0.3333333333333333,0
PVP01_1233700,575,10,14,599,0.9599332220367279,0.01669449081803005,0.02337228714524207
PVP01_1233600,2417,115,202,2734,0.8840526700804682,0.04206291148500366,0.07388441843452817
PVP01_1233500,432,4,23,459,0.9411764705882353,0.008714596949891068,0.05010893246187364
PVP01_1233200,39,11,12,62,0.6290322580645161,0.1774193548387097,0.1935483870967742
PVP01_1233000,462,863,231,1556,0.2969151670951157,0.5546272493573264,0.14845758354755784
PVP01_1232800,56,6,96,158,0.35443037974683544,0.0379746835443038,0.6075949367088608
PVP01_1232700,33,4,20,57,0.5789473684210527,0.07017543859649122,0.3508771929824561
PVP01_1232600,2335,247,294,2876,0.8118915159944368,0.08588317107093185,0.10222531293463143
PVP01_1232300,762,23,59,844,0.9028436018957346,0.027251184834123223,0.06990521327014218
PVP01_1232100,1430,72,111,1613,0.8865468071915685,0.044637321760694355,0.06881587104773713
PVP01_1231800,1459,55,30,1544,0.9449481865284974,0.03562176165803109,0.019430051813471502
PVP01_1231700,17,2,4,23,0.7391304347826086,0.08695652173913043,0.17391304347826086
PVP01_1231600,65,1,1,67,0.9701492537313433,0.014925373134328358,0.014925373134328358
PVP01_1231500,4008,1826,122,5956,0.6729348556077904,0.30658159838818,0.02048354600402955
PVP01_1231400,271,29,3,303,0.8943894389438944,0.09570957095709572,0.009900990099009901
PVP01_1231300,236,13,5,254,0.9291338582677166,0.051181102362204724,0.01968503937007874
PVP01_1231200,6207,4089,667,10963,0.5661771412934415,0.3729818480342972,0.06084101067226124
PVP01_1231100,93,5,57,155,0.6,0.03225806451612903,0.36774193548387096
PVP01_1231000,1962,100,59,2121,0.925035360678925,0.04714757190004715,0.027817067421027818
PVP01_1230900,46,0,111,157,0.2929936305732484,0,0.7070063694267515
PVP01_1230800,312,147,60,519,0.6011560693641619,0.2832369942196532,0.11560693641618497
PVP01_1230700,677,355,83,1115,0.6071748878923767,0.3183856502242152,0.07443946188340807
PVP01_1230600,190,158,31,379,0.5013192612137203,0.41688654353562005,0.08179419525065963
PVP01_1230500,329,6,10,345,0.9536231884057971,0.017391304347826087,0.028985507246376812
PVP01_1230400,1792,188,1074,3054,0.5867714472822528,0.06155861165684348,0.3516699410609037
PVP01_1230200,521,45,71,637,0.8178963893249608,0.0706436420722135,0.11145996860282574
PVP01_1230100,1307,85,164,1556,0.839974293059126,0.05462724935732648,0.10539845758354756
PVP01_1229900,113,29,38,180,0.6277777777777778,0.16111111111111112,0.2111111111111111
PVP01_1229800,758,53,18,829,0.9143546441495778,0.06393244873341375,0.021712907117008445
PVP01_1229700,5950,1535,230,7715,0.7712248865845756,0.19896305897602073,0.029812054439403757
PVP01_1229600,394,34,10,438,0.8995433789954338,0.0776255707762557,0.0228310502283105
PVP01_1229500,316,209,5,530,0.5962264150943396,0.39433962264150946,0.009433962264150943
PVP01_1229400,29,1,0,30,0.9666666666666667,0.03333333333333333,0
PVP01_1229100,224,19,11,254,0.8818897637795275,0.07480314960629922,0.04330708661417323
PVP01_1229000,43,0,6,49,0.8775510204081632,0,0.12244897959183673
PVP01_1228900,277,4,112,393,0.7048346055979644,0.010178117048346057,0.28498727735368956
PVP01_1228500,654,23,436,1113,0.5876010781671159,0.020664869721473494,0.3917340521114106
PVP01_1228200,2,2,1,5,0.4,0.4,0.2
PVP01_1228100,2854,605,84,3543,0.8055320349985887,0.17075924357888794,0.023708721422523286
PVP01_1228000,2139,365,56,2560,0.835546875,0.142578125,0.021875
PVP01_1227700,370,61,72,503,0.73558648111332,0.12127236580516898,0.14314115308151093
PVP01_1227600,1426,86,137,1649,0.8647665251667678,0.05215281989084294,0.08308065494238932
PVP01_1227400,374,78,28,480,0.7791666666666667,0.1625,0.058333333333333334
PVP01_1227300,63,16,8,87,0.7241379310344828,0.1839080459770115,0.09195402298850575
PVP01_1227200,1223,604,94,1921,0.6366475793857366,0.3144195731389901,0.048932847475273294
PVP01_1227000,1740,63,819,2622,0.6636155606407322,0.02402745995423341,0.3123569794050343
PVP01_1226900,339,14,911,1264,0.26819620253164556,0.011075949367088608,0.7207278481012658
PVP01_1226800,86,527,112,725,0.11862068965517242,0.7268965517241379,0.15448275862068966
PVP01_1226700,327,16,15,358,0.9134078212290503,0.0446927374301676,0.04189944134078212
PVP01_1226600,1136,1315,53,2504,0.4536741214057508,0.5251597444089456,0.021166134185303515
PVP01_1226500,0,0,0,0,NaN,NaN,NaN
PVP01_1226300,940,40,28,1008,0.9325396825396826,0.03968253968253968,0.027777777777777776
PVP01_1226100,564,17,1652,2233,0.25257501119570086,0.00761307657859382,0.7398119122257053
PVP01_1226000,174,17,7,198,0.8787878787878788,0.08585858585858586,0.03535353535353535
PVP01_1225800,173,17,3,193,0.8963730569948186,0.08808290155440414,0.015544041450777202
PVP01_1225700,181,18,11,210,0.861904761904762,0.08571428571428572,0.05238095238095238
PVP01_1225600,747,108,133,988,0.7560728744939271,0.10931174089068826,0.1346153846153846
PVP01_1225300,35,1,8,44,0.7954545454545454,0.022727272727272728,0.18181818181818182
PVP01_1225200,2218,49,117,2384,0.9303691275167785,0.020553691275167787,0.04907718120805369
PVP01_1225100,661,10,1309,1980,0.3338383838383838,0.005050505050505051,0.6611111111111111
PVP01_1225000,644,767,112,1523,0.42284963887065,0.5036112934996717,0.07353906762967827
PVP01_1224800,1,1,142,144,0.006944444444444444,0.006944444444444444,0.9861111111111112
PVP01_1224700,592,295,1054,1941,0.3049974240082432,0.1519835136527563,0.5430190623390005
PVP01_1224600,202,36,31,269,0.7509293680297398,0.13382899628252787,0.11524163568773234
PVP01_1224500,84,2,0,86,0.9767441860465116,0.023255813953488372,0
PVP01_1224400,1498,100,72,1670,0.89700598802395215,0.059880239520958084,0.04311377245508982
PVP01_1224300,978,65,41,1084,0.9022140221402214,0.05996309963099631,0.03782287822878229
PVP01_1224200,524,36,85,645,0.8124031007751938,0.05581395348837209,0.13178294573643412
PVP01_1224100,1000,31,284,1315,0.7604562737642585,0.023574144486692015,0.21596958174904943
PVP01_1224000,2196,56,1097,3349,0.6557181248133771,0.016721409375933114,0.32756046581068976
PVP01_1223800,507,8,8,523,0.9694072657743786,0.015296367112810707,0.015296367112810707
PVP01_1223600,440,27,2927,3394,0.1296405421331762,0.007955215085444903,0.862404242781379
PVP01_1223500,90,15,2,107,0.8411214953271028,0.14018691588785046,0.018691588785046728
PVP01_1223400,1526,694,43,2263,0.6743261157755193,0.30667255855059655,0.019001325673884226
PVP01_1223300,261,6,7,274,0.9525547445255474,0.021897810218978103,0.025547445255474453
PVP01_1223000,1057,25,169,1251,0.8449240607513989,0.019984012789768184,0.13509192645883294
PVP01_1222900,2871,372,79,3322,0.8642384105960265,0.11198073449729079,0.023780854906682723
PVP01_1222700,209,38,14,261,0.8007662835249042,0.14559386973180077,0.05363984674329502
PVP01_1222600,256,4,34,294,0.8707482993197279,0.013605442176870748,0.11564625850340136
PVP01_1222400,367,33,7,407,0.9017199017199017,0.08108108108108109,0.0171990171990172
PVP01_1222200,89,32,6,127,0.7007874015748031,0.25196850393700787,0.047244094488188976
PVP01_1222100,2431,82,81,2594,0.9371626831148805,0.03161141094834233,0.03122590593677718
PVP01_1222000,42,27,8,77,0.5454545454545454,0.35064935064935066,0.1038961038961039
PVP01_1221900,240,136,5,381,0.6299212598425197,0.3569553805774278,0.013123359580052493
PVP01_1221500,3572,77,264,3913,0.9128545872731919,0.01967799642218247,0.0674674163046256
PVP01_1221400,351,45,6,402,0.8731343283582089,0.11194029850746269,0.014925373134328358
PVP01_1221300,938,89,15,1042,0.9001919385796545,0.0854126679462572,0.014395393474088292
PVP01_1221200,1659,277,355,2291,0.7241379310344828,0.12090790048013968,0.15495416848537757
PVP01_1221000,506,13,165,684,0.7397660818713451,0.019005847953216373,0.2412280701754386
PVP01_1220900,996,232,52,1280,0.778125,0.18125,0.040625
PVP01_1220800,2890,84,1168,4142,0.6977305649444713,0.020280057943022695,0.28198937711250605
PVP01_1220700,62,1,19,82,0.7560975609756098,0.012195121951219513,0.23170731707317074
PVP01_1220600,1818,137,79,2034,0.8938053097345132,0.06735496558505408,0.03883972468043265
PVP01_1220500,1851,570,63,2484,0.7451690821256038,0.22946859903381642,0.025362318840579712
PVP01_1219000,18,9,8,35,0.5142857142857142,0.2571428571428571,0.22857142857142856
PVP01_1218900,2293,173,87,2553,0.8981590285938112,0.06776341558950255,0.03407755581668625
PVP01_1218800,2284,143,114,2541,0.8988587170405352,0.05627705627705628,0.0448642266824085
PVP01_1218700,45,1,2,48,0.9375,0.020833333333333332,0.041666666666666664
PVP01_1218600,3343,480,341,4164,0.80283381364073,0.11527377521613832,0.0818924111431316
PVP01_1218500,147,4,17,168,0.875,0.023809523809523808,0.10119047619047619
PVP01_1218300,40,5,9,54,0.7407407407407407,0.09259259259259259,0.16666666666666666
PVP01_1218100,228,1,40,269,0.8475836431226765,0.0037174721189591076,0.14869888475836432
PVP01_1217900,2710,1157,64,3931,0.6893920122106334,0.2943271432205546,0.016280844568812007
PVP01_1217800,300,48,8,356,0.8426966292134831,0.1348314606741573,0.02247191011235955
PVP01_1217700,650,52,71,773,0.8408796895213454,0.06727037516170763,0.09184993531694696
PVP01_1217600,64,1,3,68,0.9411764705882353,0.014705882352941176,0.04411764705882353
PVP01_1217500,1187,340,842,2369,0.5010552975939215,0.14352047277332208,0.35542422963275644
PVP01_1217400,534,75,118,727,0.734525447042641,0.1031636863823934,0.1623108665749656
PVP01_1217300,3127,566,249,3942,0.7932521562658549,0.14358193810248604,0.06316590563165905
PVP01_1217000,149,20,2947,3116,0.047817715019255455,0.006418485237483954,0.9457637997432606
PVP01_1216700,1654,29,295,1978,0.8361981799797775,0.014661274014155713,0.14914054600606674
PVP01_1216600,199,6,7,212,0.9386792452830188,0.02830188679245283,0.0330188679245283
PVP01_1216500,4932,2496,168,7596,0.6492890995260664,0.3285939968404423,0.022116903633491312
PVP01_1216400,8431,1837,319,10587,0.7963540190800038,0.17351468782469065,0.030131293095305562
PVP01_1216300,744,10,54,808,0.9207920792079208,0.012376237623762377,0.06683168316831684
PVP01_1216200,527,48,29,604,0.8725165562913907,0.07947019867549669,0.048013245033112585
PVP01_1216100,3208,100,170,3478,0.9223691776883266,0.02875215641173088,0.0488786658999425
PVP01_1216000,277,8,135,420,0.6595238095238095,0.01904761904761905,0.32142857142857145
PVP01_1215900,23,4,4,31,0.7419354838709677,0.12903225806451613,0.12903225806451613
PVP01_1215800,782,27,30,839,0.932061978545888,0.03218116805721097,0.03575685339690107
PVP01_1215400,188,5,111,304,0.618421052631579,0.01644736842105263,0.3651315789473684
PVP01_1215300,717,54,17,788,0.9098984771573604,0.06852791878172589,0.021573604060913704
PVP01_1215200,785,65,25,875,0.8971428571428571,0.07428571428571429,0.02857142857142857
PVP01_1215000,373,18,19,410,0.9097560975609756,0.04390243902439024,0.046341463414634146
PVP01_1214900,290,11,71,372,0.7795698924731183,0.02956989247311828,0.19086021505376344
PVP01_1214700,174,27,9,210,0.8285714285714286,0.12857142857142856,0.04285714285714286
PVP01_1214600,7,3,0,10,0.7,0.3,0
PVP01_1214500,1293,2189,139,3621,0.35708367854183926,0.6045291355979011,0.0383871858602596
PVP01_1214400,16,5,6,27,0.5925925925925926,0.18518518518518517,0.2222222222222222
PVP01_1214200,853,149,176,1178,0.7241086587436333,0.1264855687606112,0.1494057724957555
PVP01_1214100,942,16,333,1291,0.7296669248644462,0.012393493415956624,0.2579395817195972
PVP01_1214000,19,1,3,23,0.8260869565217391,0.043478260869565216,0.13043478260869565
PVP01_1213900,241,208,37,486,0.49588477366255146,0.4279835390946502,0.07613168724279835
PVP01_1213600,3056,2121,131,5308,0.5757347400150716,0.39958553127354934,0.02467972871137905
PVP01_1213400,1941,1372,78,3391,0.5723975228546152,0.40460041285756415,0.0230020642878207
PVP01_1213300,1,1,3,5,0.2,0.2,0.6
PVP01_1213200,1163,29,28,1220,0.9532786885245902,0.023770491803278688,0.022950819672131147
PVP01_1213100,571,14,358,943,0.6055143160127253,0.014846235418875928,0.3796394485683987
PVP01_1213000,4,1,2,7,0.5714285714285714,0.14285714285714285,0.2857142857142857
PVP01_1212900,486,55,15,556,0.8741007194244604,0.09892086330935251,0.02697841726618705
PVP01_1212800,9824,4534,316,14674,0.6694834400981328,0.30898187270001365,0.021534687201853617
PVP01_1212700,1363,44,357,1764,0.7726757369614512,0.024943310657596373,0.20238095238095238
PVP01_1212600,433,38,33,504,0.8591269841269841,0.07539682539682539,0.06547619047619048
PVP01_1212500,63,2,3,68,0.9264705882352942,0.029411764705882353,0.04411764705882353
PVP01_1212300,24,1,7,32,0.75,0.03125,0.21875
PVP01_1212200,26,148,739,913,0.028477546549835708,0.16210295728368018,0.8094194961664841
PVP01_1212100,689,148,45,882,0.7811791383219955,0.16780045351473924,0.05102040816326531
PVP01_1212000,77,5,4,86,0.8953488372093024,0.05813953488372093,0.046511627906976744
PVP01_1211700,116,13,1613,1742,0.06659012629161883,0.007462686567164179,0.925947187141217
PVP01_1211600,437,441,78,956,0.4571129707112971,0.46129707112970714,0.08158995815899582
PVP01_1211500,2310,45,178,2533,0.9119621002763522,0.017765495459928938,0.0702724042637189
PVP01_1211400,795,27,53,875,0.9085714285714286,0.030857142857142857,0.060571428571428575
PVP01_1211300,1278,46,281,1605,0.7962616822429907,0.02866043613707165,0.1750778816199377
PVP01_1211200,196,12,4,212,0.9245283018867925,0.05660377358490566,0.018867924528301886
PVP01_1211100,1650,1561,306,3517,0.4691498436167188,0.44384418538527154,0.08700597099800966
PVP01_1210900,1184,156,88,1428,0.8291316526610645,0.1092436974789916,0.06162464985994398
PVP01_1210800,1588,156,38,1782,0.8911335578002245,0.08754208754208755,0.02132435465768799
PVP01_1210600,2323,480,78,2881,0.8063172509545297,0.16660881638320027,0.027073932662270046
PVP01_1210300,42,1,1,44,0.9545454545454546,0.022727272727272728,0.022727272727272728
PVP01_1210200,559,20,13,592,0.9442567567567568,0.033783783783783786,0.02195945945945946
PVP01_1210100,1535,84,42,1661,0.9241420830824805,0.050571944611679714,0.025285972305839857
PVP01_1210000,344,14,17,375,0.9173333333333333,0.037333333333333336,0.04533333333333334
PVP01_1209800,10,1,20,31,0.3225806451612903,0.03225806451612903,0.6451612903225806
PVP01_1209700,317,201,125,643,0.49300155520995337,0.31259720062208396,0.19440124416796267
PVP01_1209600,1327,146,27,1500,0.8846666666666667,0.09733333333333333,0.018
PVP01_1209500,695,31,331,1057,0.6575212866603595,0.0293282876064333,0.31315042573320717
PVP01_1209400,4116,114,171,4401,0.9352419904567144,0.025903203817314247,0.03885480572597137
PVP01_1209300,384,17,4,405,0.9481481481481482,0.04197530864197531,0.009876543209876543
PVP01_1209200,5,2,659,666,0.0075075075075075074,0.003003003003003003,0.9894894894894894
PVP01_1209100,659,28,23,710,0.928169014084507,0.03943661971830986,0.0323943661971831
PVP01_1209000,733,68,34,835,0.8778443113772455,0.081437125748503,0.0407185628742515
PVP01_1208900,860,11,22,893,0.9630459126539753,0.012318029115341545,0.02463605823068309
PVP01_1208800,338,8,66,412,0.8203883495145631,0.019417475728155338,0.16019417475728157
PVP01_1208700,690,44,51,785,0.8789808917197452,0.05605095541401274,0.06496815286624204
PVP01_1208600,619,142,17,778,0.7956298200514139,0.18251928020565553,0.021850899742930592
PVP01_1208500,1545,818,40,2403,0.6429463171036205,0.340407823553891,0.016645859342488557
PVP01_1208300,985,457,63,1505,0.654485049833887,0.3036544850498339,0.04186046511627907
PVP01_1208200,1853,57,66,1976,0.937753036437247,0.028846153846153848,0.03340080971659919
PVP01_1207800,309,10,6,325,0.9507692307692308,0.03076923076923077,0.018461538461538463
PVP01_1207600,1435,759,56,2250,0.6377777777777778,0.3373333333333333,0.024888888888888887
PVP01_1207400,356,183,25,564,0.6312056737588653,0.324468085106383,0.044326241134751775
PVP01_1207300,4665,1243,166,6074,0.7680276588738887,0.20464273954560422,0.02732960158050708
PVP01_1207200,74,12,46,132,0.5606060606060606,0.09090909090909091,0.3484848484848485
PVP01_1207100,366,97,185,648,0.5648148148148148,0.14969135802469136,0.2854938271604938
PVP01_1206800,149,1,140,290,0.5137931034482759,0.0034482758620689655,0.4827586206896552
PVP01_1206700,14,0,4,18,0.7777777777777778,0,0.2222222222222222
PVP01_1206600,385,101,793,1279,0.30101641907740423,0.07896794370602032,0.6200156372165755
PVP01_1206500,799,185,89,1073,0.744641192917055,0.1724137931034483,0.08294501397949673
PVP01_1206300,237,49,9,295,0.8033898305084746,0.16610169491525423,0.030508474576271188
PVP01_1206200,233,4,1016,1253,0.18595371109337588,0.0031923383878691143,0.810853950518755
PVP01_1206100,7,1,0,8,0.875,0.125,0
PVP01_1206000,26,2,12,40,0.65,0.05,0.3
PVP01_1205900,401,42,17,460,0.8717391304347826,0.09130434782608696,0.036956521739130437
PVP01_1205800,204,2,4,210,0.9714285714285714,0.009523809523809525,0.01904761904761905
PVP01_1205700,246,8,27,281,0.8754448398576512,0.028469750889679714,0.09608540925266904
PVP01_1205600,635,193,123,951,0.6677181913774973,0.20294426919032596,0.12933753943217666
PVP01_1205400,261,32,92,385,0.6779220779220779,0.08311688311688312,0.23896103896103896
PVP01_1205200,892,17,150,1059,0.842304060434372,0.016052880075542966,0.141643059490085
PVP01_1205100,113,4,215,332,0.34036144578313254,0.012048192771084338,0.6475903614457831
PVP01_1205000,966,698,54,1718,0.5622817229336438,0.4062863795110594,0.03143189755529686
PVP01_1204900,77,3,2,82,0.9390243902439024,0.036585365853658534,0.024390243902439025
PVP01_1204800,2,1,1,4,0.5,0.25,0.25
PVP01_1204700,1620,153,106,1879,0.8621607237892496,0.08142629058009579,0.056412985630654604
PVP01_1204600,208,74,4,286,0.7272727272727273,0.25874125874125875,0.013986013986013986
PVP01_1204500,576,523,36,1135,0.507488986784141,0.46079295154185024,0.03171806167400881
PVP01_1204400,818,35,102,955,0.856544502617801,0.03664921465968586,0.1068062827225131
PVP01_1204300,770,174,2313,3257,0.23641387780165796,0.05342339576297206,0.7101627264353699
PVP01_1204200,26,7,507,540,0.04814814814814815,0.012962962962962963,0.9388888888888889
PVP01_1204100,3197,171,72,3440,0.9293604651162791,0.04970930232558139,0.020930232558139535
PVP01_1204000,54,11,15,80,0.675,0.1375,0.1875
PVP01_1203900,11,0,6,17,0.6470588235294118,0,0.35294117647058826
PVP01_1203700,480,37,14,531,0.903954802259887,0.0696798493408663,0.026365348399246705
PVP01_1203600,1465,128,196,1789,0.8188932364449413,0.07154835103409726,0.10955841252096143
PVP01_1203500,31,4,0,35,0.8857142857142857,0.11428571428571428,0
PVP01_1203300,4521,2085,127,6733,0.6714688845982474,0.309668795484925,0.018862319916827564
PVP01_1203200,1420,35,20,1475,0.9627118644067797,0.023728813559322035,0.013559322033898305
PVP01_1203000,49,25,29,103,0.47572815533980584,0.24271844660194175,0.2815533980582524
PVP01_1202700,363,85,321,769,0.4720416124837451,0.11053315994798439,0.4174252275682705
PVP01_1202600,86,194,9,289,0.2975778546712803,0.671280276816609,0.031141868512110725
PVP01_1202500,1443,224,69,1736,0.831221198156682,0.12903225806451613,0.039746543778801845
PVP01_1202400,1298,142,147,1587,0.8178954001260239,0.08947700063011972,0.09262759924385633
PVP01_1202300,4196,88,436,4720,0.8889830508474577,0.01864406779661017,0.0923728813559322
PVP01_1202100,887,292,41,1220,0.7270491803278688,0.23934426229508196,0.03360655737704918
PVP01_1202000,770,23,15,808,0.9529702970297029,0.028465346534653466,0.018564356435643563
PVP01_1403100,39,67,52,158,0.2468354430379747,0.4240506329113924,0.3291139240506329
PVP01_1403300,0,0,0,0,NaN,NaN,NaN
PVP01_1403500,396,179,13,588,0.673469387755102,0.304421768707483,0.022108843537414966
PVP01_1403600,1232,1402,84,2718,0.45327446651949965,0.5158204562178073,0.03090507726269316
PVP01_1403700,5695,2215,153,8063,0.7063127868039192,0.27471164578940843,0.018975567406672455
PVP01_1403800,115,18,1,134,0.8582089552238806,0.13432835820895522,0.007462686567164179
PVP01_1403900,100,4,6,110,0.9090909090909091,0.03636363636363636,0.05454545454545454
PVP01_1404000,437,17,27,481,0.9085239085239085,0.035343035343035345,0.056133056133056136
PVP01_1404100,255,29,6,290,0.8793103448275862,0.1,0.020689655172413793
PVP01_1404200,2163,186,60,2409,0.8978829389788294,0.07721046077210461,0.024906600249066
PVP01_1404300,769,813,46,1628,0.47235872235872234,0.49938574938574937,0.028255528255528257
PVP01_1404500,94,6,18,118,0.7966101694915254,0.05084745762711865,0.15254237288135594
PVP01_1404900,2014,42,459,2515,0.8007952286282306,0.016699801192842943,0.18250497017892645
PVP01_1405000,1468,42,625,2135,0.6875878220140516,0.019672131147540985,0.2927400468384075
PVP01_1405100,506,17,26,549,0.9216757741347905,0.030965391621129327,0.04735883424408015
PVP01_1405200,436,16,3,455,0.9582417582417583,0.035164835164835165,0.006593406593406593
PVP01_1405300,963,80,23,1066,0.9033771106941839,0.075046904315197,0.021575984990619138
PVP01_1405600,234,8,5,247,0.9473684210526315,0.032388663967611336,0.020242914979757085
PVP01_1405800,105,32,1,138,0.7608695652173914,0.2318840579710145,0.007246376811594203
PVP01_1405900,1202,20,162,1384,0.8684971098265896,0.014450867052023121,0.11705202312138728
PVP01_1406000,279,13,10,302,0.9238410596026491,0.04304635761589404,0.033112582781456956
PVP01_1406100,956,58,20,1034,0.9245647969052224,0.05609284332688588,0.019342359767891684
PVP01_1406200,1062,314,34,1410,0.7531914893617021,0.2226950354609929,0.024113475177304965
PVP01_1406300,1053,103,203,1359,0.7748344370860927,0.07579102281089035,0.14937454010301693
PVP01_1406400,590,36,26,652,0.9049079754601227,0.05521472392638037,0.03987730061349693
PVP01_1406500,874,31,17,922,0.9479392624728851,0.033622559652928416,0.01843817787418655
PVP01_1406600,70,5,1,76,0.9210526315789473,0.06578947368421052,0.013157894736842105
PVP01_1406700,3,1,0,4,0.75,0.25,0
PVP01_1406800,969,170,51,1190,0.8142857142857143,0.14285714285714285,0.04285714285714286
PVP01_1407000,28,5,0,33,0.8484848484848485,0.15151515151515152,0
PVP01_1407100,280,7,8,295,0.9491525423728814,0.023728813559322035,0.02711864406779661
PVP01_1407200,896,70,24,990,0.9050505050505051,0.0707070707070707,0.024242424242424242
PVP01_1407300,2148,129,248,2525,0.8506930693069307,0.051089108910891086,0.09821782178217822
PVP01_1407400,616,8,12,636,0.9685534591194969,0.012578616352201259,0.018867924528301886
PVP01_1407500,109,13,5,127,0.8582677165354331,0.10236220472440945,0.03937007874015748
PVP01_1407600,2010,427,124,2561,0.7848496680983991,0.16673174541194846,0.04841858648965248
PVP01_1407700,1272,515,64,1851,0.6871961102106969,0.2782279848730416,0.03457590491626148
PVP01_1407900,116,42,3,161,0.7204968944099379,0.2608695652173913,0.018633540372670808
PVP01_1408000,326,759,104,1189,0.27417998317914216,0.6383515559293524,0.08746846089150546
PVP01_1408100,1581,289,38,1908,0.8286163522012578,0.15146750524109015,0.019916142557651992
PVP01_1408200,2211,194,46,2451,0.9020807833537332,0.07915136678906569,0.018767849857201143
PVP01_1408300,95,5,7,107,0.8878504672897196,0.04672897196261682,0.06542056074766354
PVP01_1408400,48,3,144,195,0.24615384615384617,0.015384615384615385,0.7384615384615385
PVP01_1408500,146,18,26,190,0.7684210526315789,0.09473684210526316,0.1368421052631579
PVP01_1408700,1435,83,778,2296,0.625,0.03614982578397213,0.33885017421602787
PVP01_1408900,756,19,2111,2886,0.26195426195426197,0.006583506583506584,0.7314622314622314
PVP01_1409000,120,17,2803,2940,0.04081632653061224,0.005782312925170068,0.9534013605442176
PVP01_1409100,360,3,6,369,0.975609756097561,0.008130081300813009,0.016260162601626018
PVP01_1409200,1412,768,66,2246,0.628673196794301,0.3419412288512912,0.029385574354407838
PVP01_1409300,252,155,23,430,0.586046511627907,0.36046511627906974,0.053488372093023255
PVP01_1409500,413,16,110,539,0.7662337662337663,0.029684601113172542,0.20408163265306123
PVP01_1409600,211,22,5,238,0.8865546218487395,0.09243697478991597,0.02100840336134454
PVP01_1409800,1850,38,271,2159,0.8568781843446039,0.01760074108383511,0.12552107457156092
PVP01_1409900,352,172,52,576,0.6111111111111112,0.2986111111111111,0.09027777777777778
PVP01_1410000,36,10,1,47,0.7659574468085106,0.2127659574468085,0.02127659574468085
PVP01_1410100,9426,4299,518,14243,0.6617987783472583,0.3018324791125465,0.03636874254019518
PVP01_1410200,226,60,91,377,0.5994694960212201,0.15915119363395225,0.2413793103448276
PVP01_1410300,1681,659,55,2395,0.7018789144050105,0.27515657620041756,0.022964509394572025
PVP01_1410400,141,53,3,197,0.7157360406091371,0.26903553299492383,0.015228426395939087
PVP01_1410500,362,202,114,678,0.5339233038348082,0.29793510324483774,0.168141592920354
PVP01_1410600,427,92,40,559,0.7638640429338104,0.16457960644007155,0.07155635062611806
PVP01_1410700,989,266,34,1289,0.7672614429790535,0.20636152055857254,0.026377036462373934
PVP01_1410800,573,87,12,672,0.8526785714285714,0.12946428571428573,0.017857142857142856
PVP01_1410900,23,3,0,26,0.8846153846153846,0.11538461538461539,0
PVP01_1411000,1433,61,90,1584,0.9046717171717171,0.03851010101010101,0.056818181818181816
PVP01_1411100,203,17,9,229,0.8864628820960698,0.07423580786026202,0.039301310043668124
PVP01_1411200,10,6,1463,1479,0.0067613252197430695,0.004056795131845842,0.9891818796484111
PVP01_1411300,16,14,1,31,0.5161290322580645,0.45161290322580644,0.03225806451612903
PVP01_1411500,440,47,8,495,0.8888888888888888,0.09494949494949495,0.01616161616161616
PVP01_1411600,10,0,0,10,1,0,0
PVP01_1411700,51,37,1860,1948,0.026180698151950718,0.018993839835728953,0.9548254620123203
PVP01_1411800,854,551,46,1451,0.5885596140592695,0.3797381116471399,0.03170227429359063
PVP01_1411900,1085,214,42,1341,0.8090976882923192,0.15958240119313946,0.03131991051454139
PVP01_1412000,416,63,36,515,0.8077669902912621,0.12233009708737864,0.06990291262135923
PVP01_1412100,207,20,46,273,0.7582417582417582,0.07326007326007326,0.1684981684981685
PVP01_1412200,374,66,9,449,0.8329621380846325,0.14699331848552338,0.0200445434298441
PVP01_1412300,964,18,23,1005,0.9592039800995025,0.01791044776119403,0.022885572139303482
PVP01_1412400,135,5,4,144,0.9375,0.034722222222222224,0.027777777777777776
PVP01_1412500,452,33,22,507,0.8915187376725838,0.0650887573964497,0.04339250493096647
PVP01_1412600,1053,945,855,2853,0.36908517350157727,0.3312302839116719,0.2996845425867508
PVP01_1412700,55,7,40,102,0.5392156862745098,0.06862745098039216,0.39215686274509803
PVP01_1412800,3524,918,261,4703,0.7493089517329364,0.1951945566659579,0.055496491601105674
PVP01_1412900,213,53,24,290,0.7344827586206897,0.18275862068965518,0.08275862068965517
PVP01_1413000,7,0,1,8,0.875,0,0.125
PVP01_1413200,839,30,87,956,0.8776150627615062,0.03138075313807531,0.09100418410041841
PVP01_1413300,761,61,15,837,0.9091995221027479,0.07287933094384708,0.017921146953405017
PVP01_1413400,539,81,11,631,0.8541996830427893,0.12836767036450078,0.017432646592709985
PVP01_1413500,8,0,0,8,1,0,0
PVP01_1413600,730,10,21,761,0.9592641261498029,0.013140604467805518,0.02759526938239159
PVP01_1413800,1871,371,123,2365,0.7911205073995772,0.15687103594080337,0.05200845665961945
PVP01_1413900,310,7,10,327,0.9480122324159022,0.021406727828746176,0.03058103975535168
PVP01_1414100,139,8,4,151,0.9205298013245033,0.052980132450331126,0.026490066225165563
PVP01_1414200,142,3,4,149,0.9530201342281879,0.020134228187919462,0.026845637583892617
PVP01_1414300,3033,344,75,3452,0.8786210892236385,0.0996523754345307,0.021726535341830822
PVP01_1414600,503,176,11,690,0.7289855072463768,0.25507246376811593,0.015942028985507246
PVP01_1414800,1839,354,106,2299,0.7999130056546324,0.15397999130056547,0.046107003044802086
PVP01_1414900,785,92,42,919,0.8541893362350381,0.10010881392818281,0.04570184983677911
PVP01_1415000,509,61,17,587,0.8671209540034072,0.10391822827938671,0.028960817717206135
PVP01_1415200,620,32,10,662,0.9365558912386707,0.04833836858006042,0.015105740181268883
PVP01_1415300,320,7,29,356,0.898876404494382,0.019662921348314606,0.08146067415730338
PVP01_1415500,103,17,4,124,0.8306451612903226,0.13709677419354838,0.03225806451612903
PVP01_1415600,1476,197,170,1843,0.8008681497558329,0.1068909386869235,0.09224091155724362
PVP01_1415700,142,6,25,173,0.8208092485549133,0.03468208092485549,0.14450867052023122
PVP01_1415800,1497,91,35,1623,0.922365988909427,0.056069008009858284,0.021565003080714726
PVP01_1415900,346,51,241,638,0.542319749216301,0.07993730407523511,0.3777429467084639
PVP01_1416000,12,0,110,122,0.09836065573770492,0,0.9016393442622951
PVP01_1416100,65,5,12,82,0.7926829268292683,0.06097560975609756,0.14634146341463414
PVP01_1416200,39,0,50,89,0.43820224719101125,0,0.5617977528089888
PVP01_1416300,729,351,224,1304,0.5590490797546013,0.2691717791411043,0.17177914110429449
PVP01_1416400,1945,897,813,3655,0.5321477428180574,0.2454172366621067,0.22243502051983585
PVP01_1416500,1398,54,410,1862,0.7508055853920516,0.02900107411385607,0.22019334049409237
PVP01_1416600,1231,95,192,1518,0.810935441370224,0.06258234519104085,0.12648221343873517
PVP01_1416700,446,119,35,600,0.7433333333333333,0.19833333333333333,0.058333333333333334
PVP01_1416800,83,50,5,138,0.6014492753623188,0.36231884057971014,0.036231884057971016
PVP01_1416900,46,11,31,88,0.5227272727272727,0.125,0.3522727272727273
PVP01_1417000,537,48,44,629,0.8537360890302067,0.07631160572337042,0.06995230524642289
PVP01_1417100,49,3,1,53,0.9245283018867925,0.05660377358490566,0.018867924528301886
PVP01_1417200,84,9,51,144,0.5833333333333334,0.0625,0.3541666666666667
PVP01_1417300,518,8,169,695,0.7453237410071942,0.011510791366906475,0.24316546762589927
PVP01_1417400,1614,320,351,2285,0.7063457330415754,0.1400437636761488,0.1536105032822757
PVP01_1417600,9,0,10,19,0.47368421052631576,0,0.5263157894736842
PVP01_1417700,1191,47,43,1281,0.9297423887587822,0.03669008587041374,0.03356752537080406
PVP01_1417800,2003,136,117,2256,0.887854609929078,0.06028368794326241,0.05186170212765957
PVP01_1417900,1846,85,50,1981,0.9318525996971226,0.042907622412922765,0.02523977788995457
PVP01_1418000,1973,25,129,2127,0.9275975552421251,0.011753643629525154,0.06064880112834979
PVP01_1418200,2063,398,51,2512,0.8212579617834395,0.15843949044585987,0.020302547770700636
PVP01_1418300,1662,269,28,1959,0.8483920367534457,0.13731495661051557,0.014293006636038795
PVP01_1418400,4,0,0,4,1,0,0
PVP01_1418500,1136,21,82,1239,0.9168684422921711,0.01694915254237288,0.06618240516545601
PVP01_1418600,86,30,6,122,0.7049180327868853,0.2459016393442623,0.04918032786885246
PVP01_1418700,1693,565,52,2310,0.7329004329004329,0.24458874458874458,0.022510822510822513
PVP01_1418800,852,804,70,1726,0.4936268829663963,0.46581691772885286,0.04055619930475087
PVP01_1418900,4,0,52,56,0.07142857142857142,0,0.9285714285714286
PVP01_1419000,280,16,15,311,0.9003215434083601,0.05144694533762058,0.04823151125401929
PVP01_1419100,50,2,4,56,0.8928571428571429,0.03571428571428571,0.07142857142857142
PVP01_1419300,917,17,22,956,0.9592050209205021,0.01778242677824268,0.02301255230125523
PVP01_1419400,52,0,7,59,0.8813559322033898,0,0.11864406779661017
PVP01_1419500,753,27,12,792,0.9507575757575758,0.03409090909090909,0.015151515151515152
PVP01_1419600,26,13,563,602,0.04318936877076412,0.02159468438538206,0.9352159468438538
PVP01_1419700,85,30,40,155,0.5483870967741935,0.1935483870967742,0.25806451612903225
PVP01_1420000,1370,520,966,2856,0.4796918767507003,0.18207282913165265,0.3382352941176471
PVP01_1420200,930,786,36,1752,0.5308219178082192,0.4486301369863014,0.02054794520547945
PVP01_1420300,4389,82,483,4954,0.8859507468712152,0.016552280985062576,0.09749697214372224
PVP01_1420400,7,0,0,7,1,0,0
PVP01_1420600,47,7,8,62,0.7580645161290323,0.11290322580645161,0.12903225806451613
PVP01_1420800,411,103,86,600,0.685,0.17166666666666666,0.14333333333333334
PVP01_1420900,853,48,35,936,0.9113247863247863,0.05128205128205128,0.03739316239316239
PVP01_1421000,548,38,14,600,0.9133333333333333,0.06333333333333334,0.023333333333333334
PVP01_1421100,27,0,5,32,0.84375,0,0.15625
PVP01_1421200,136,13,5,154,0.8831168831168831,0.08441558441558442,0.032467532467532464
PVP01_1421300,1266,111,31,1408,0.8991477272727273,0.07883522727272728,0.022017045454545456
PVP01_1421500,1215,18,1028,2261,0.5373728438743919,0.00796107916850951,0.45466607695709865
PVP01_1421600,2966,240,266,3472,0.8542626728110599,0.06912442396313365,0.07661290322580645
PVP01_1421700,104,7,13,124,0.8387096774193549,0.056451612903225805,0.10483870967741936
PVP01_1421900,147,11,30,188,0.7819148936170213,0.05851063829787234,0.1595744680851064
PVP01_1422100,786,159,51,996,0.7891566265060241,0.15963855421686746,0.05120481927710843
PVP01_1422200,164,68,7,239,0.6861924686192469,0.28451882845188287,0.029288702928870293
PVP01_1422300,1846,28,2207,4081,0.4523401127174712,0.00686106346483705,0.5407988238176917
PVP01_1422400,162,5,29,196,0.826530612244898,0.025510204081632654,0.14795918367346939
PVP01_1422500,2315,284,268,2867,0.807464248343216,0.0990582490408092,0.09347750261597489
PVP01_1422700,1454,66,43,1563,0.9302623160588611,0.04222648752399232,0.027511196417146513
PVP01_1422800,48,7,7,62,0.7741935483870968,0.11290322580645161,0.11290322580645161
PVP01_1422900,477,16,105,598,0.7976588628762542,0.026755852842809364,0.17558528428093645
PVP01_1423200,78,15,8,101,0.7722772277227723,0.1485148514851485,0.07920792079207921
PVP01_1423400,889,552,44,1485,0.5986531986531987,0.3717171717171717,0.02962962962962963
PVP01_1423500,226,30,4,260,0.8692307692307693,0.11538461538461539,0.015384615384615385
PVP01_1423600,632,114,15,761,0.8304862023653088,0.1498028909329829,0.01971090670170828
PVP01_1423700,1323,218,124,1665,0.7945945945945946,0.13093093093093094,0.07447447447447447
PVP01_1424100,205,38,2,245,0.8367346938775511,0.15510204081632653,0.00816326530612245
PVP01_1424200,1,0,0,1,1,0,0
PVP01_1424400,123,1,3,127,0.968503937007874,0.007874015748031496,0.023622047244094488
PVP01_1424500,5,0,4,9,0.5555555555555556,0,0.4444444444444444
PVP01_1424600,23,1,2,26,0.8846153846153846,0.038461538461538464,0.07692307692307693
PVP01_1424700,1044,81,22,1147,0.9102005231037489,0.07061900610287707,0.01918047079337402
PVP01_1424800,222,11,1,234,0.9487179487179487,0.04700854700854701,0.004273504273504274
PVP01_1424900,1478,129,38,1645,0.8984802431610942,0.07841945288753799,0.023100303951367782
PVP01_1425000,933,71,18,1022,0.9129158512720157,0.06947162426614481,0.01761252446183953
PVP01_1425100,248,15,17,280,0.8857142857142857,0.05357142857142857,0.060714285714285714
PVP01_1425200,61,10,2,73,0.8356164383561644,0.136986301369863,0.0273972602739726
PVP01_1425300,385,28,7,420,0.9166666666666666,0.06666666666666667,0.016666666666666666
PVP01_1425400,872,84,20,976,0.8934426229508197,0.0860655737704918,0.020491803278688523
PVP01_1425700,7,2,3,12,0.5833333333333334,0.16666666666666666,0.25
PVP01_1425900,749,20,201,970,0.7721649484536083,0.020618556701030927,0.20721649484536084
PVP01_1426100,6208,2163,236,8607,0.7212733821308237,0.25130707563611016,0.02741954223306611
PVP01_1426200,259,23,47,329,0.7872340425531915,0.06990881458966565,0.14285714285714285
PVP01_1426300,5751,2841,166,8758,0.6566567709522723,0.32438912993834207,0.018954099109385704
PVP01_1426400,3478,1911,88,5477,0.6350191710790579,0.3489136388533869,0.01606719006755523
PVP01_1426500,47,3,6,56,0.8392857142857143,0.05357142857142857,0.10714285714285714
PVP01_1426700,1636,247,36,1919,0.8525273579989577,0.12871287128712872,0.018759770713913496
PVP01_1426800,579,32,23,634,0.9132492113564669,0.050473186119873815,0.03627760252365931
PVP01_0927100,680,49,8,737,0.9226594301221167,0.06648575305291723,0.010854816824966078
PVP01_1427000,6941,5934,323,13198,0.5259130171238067,0.4496135778148204,0.024473405061372935
PVP01_1427100,560,16,16,592,0.9459459459459459,0.02702702702702703,0.02702702702702703
PVP01_1427500,8,5,1,14,0.5714285714285714,0.35714285714285715,0.07142857142857142
PVP01_1427700,2531,1469,99,4099,0.6174676750426933,0.35838009270553794,0.024152232251768723
PVP01_1427800,1453,183,59,1695,0.8572271386430679,0.1079646017699115,0.03480825958702065
PVP01_1427900,31,0,39,70,0.44285714285714284,0,0.5571428571428572
PVP01_1428000,374,10,8,392,0.9540816326530612,0.025510204081632654,0.02040816326530612
PVP01_1428200,611,100,20,731,0.8358413132694938,0.13679890560875513,0.027359781121751026
PVP01_1428300,481,68,8,557,0.8635547576301615,0.12208258527827648,0.01436265709156194
PVP01_1428500,1572,61,23,1656,0.9492753623188406,0.03683574879227053,0.013888888888888888
PVP01_1428700,119,5,639,763,0.1559633027522936,0.00655307994757536,0.8374836173001311
PVP01_1428800,454,171,21,646,0.7027863777089783,0.2647058823529412,0.032507739938080496
PVP01_1428900,3188,203,85,3476,0.9171461449942463,0.058400460299194476,0.024453394706559262
PVP01_1429000,669,288,86,1043,0.6414189837008629,0.27612655800575264,0.08245445829338446
PVP01_1429100,2404,342,182,2928,0.8210382513661202,0.1168032786885246,0.06215846994535519
PVP01_1429200,357,21,65,443,0.8058690744920993,0.04740406320541761,0.14672686230248308
PVP01_1429300,385,4,73,462,0.8333333333333334,0.008658008658008658,0.15800865800865802
PVP01_1429400,205,3,849,1057,0.19394512771996217,0.002838221381267739,0.8032166508987701
PVP01_1429500,1095,118,19,1232,0.8887987012987013,0.09577922077922078,0.015422077922077922
PVP01_1429600,4,0,0,4,1,0,0
PVP01_1429700,119,47,7,173,0.6878612716763006,0.27167630057803466,0.04046242774566474
PVP01_1429800,598,46,17,661,0.9046898638426626,0.06959152798789713,0.025718608169440244
PVP01_1429900,496,93,122,711,0.6976090014064698,0.1308016877637131,0.17158931082981715
PVP01_1430000,2695,71,64,2830,0.9522968197879859,0.02508833922261484,0.022614840989399292
PVP01_1430100,1532,215,46,1793,0.8544339096486335,0.11991076408254323,0.025655326268823202
PVP01_1430200,400,23,17,440,0.9090909090909091,0.05227272727272727,0.038636363636363635
PVP01_1430600,18,2,1,21,0.8571428571428571,0.09523809523809523,0.047619047619047616
PVP01_1430700,625,24,17,666,0.9384384384384384,0.036036036036036036,0.025525525525525526
PVP01_1430900,1739,146,248,2133,0.8152836380684482,0.06844819503047352,0.11626816690107829
PVP01_1431100,272,35,80,387,0.7028423772609819,0.09043927648578812,0.20671834625322996
PVP01_1431200,473,58,11,542,0.8726937269372693,0.1070110701107011,0.02029520295202952
PVP01_1431300,259,20,16,295,0.8779661016949153,0.06779661016949153,0.05423728813559322
PVP01_1431400,185,25,13,223,0.8295964125560538,0.11210762331838565,0.05829596412556054
PVP01_1431500,497,49,8,554,0.8971119133574007,0.08844765342960288,0.01444043321299639
PVP01_1431600,1773,948,64,2785,0.636624775583483,0.340394973070018,0.022980251346499104
PVP01_1431700,800,62,17,879,0.9101251422070534,0.07053469852104664,0.019340159271899887
PVP01_1431800,2665,3499,196,6360,0.4190251572327044,0.5501572327044025,0.030817610062893082
PVP01_1432000,534,42,8,584,0.9143835616438356,0.07191780821917808,0.0136986301369863
PVP01_1432100,8,2,72,82,0.0975609756097561,0.024390243902439025,0.8780487804878049
PVP01_1432200,8,1,28,37,0.21621621621621623,0.02702702702702703,0.7567567567567568
PVP01_1432300,8,1,7,16,0.5,0.0625,0.4375
PVP01_1432400,18,1,5,24,0.75,0.041666666666666664,0.20833333333333334
PVP01_1432500,219,58,13,290,0.7551724137931034,0.2,0.04482758620689655
PVP01_1432600,1910,491,426,2827,0.6756278740714539,0.17368234877962505,0.15068977714892112
PVP01_1432700,991,205,27,1223,0.8103025347506132,0.16762060506950122,0.022076860179885527
PVP01_1432800,9,0,0,9,1,0,0
PVP01_1432900,1240,68,100,1408,0.8806818181818182,0.048295454545454544,0.07102272727272728
PVP01_1433000,146,10,17,173,0.8439306358381503,0.057803468208092484,0.09826589595375723
PVP01_1433100,1317,95,42,1454,0.905777166437414,0.06533700137551582,0.02888583218707015
PVP01_1433200,52,4,0,56,0.9285714285714286,0.07142857142857142,0
PVP01_1433300,41,1,4,46,0.8913043478260869,0.021739130434782608,0.08695652173913043
PVP01_1433400,292,43,14,349,0.836676217765043,0.12320916905444126,0.04011461318051576
PVP01_1433500,283,39,14,336,0.8422619047619048,0.11607142857142858,0.041666666666666664
PVP01_1433600,109,5,5,119,0.9159663865546218,0.04201680672268908,0.04201680672268908
PVP01_1433700,41,3,33,77,0.5324675324675324,0.03896103896103896,0.42857142857142855
PVP01_1433900,703,13,36,752,0.9348404255319149,0.017287234042553192,0.047872340425531915
PVP01_1434000,151,7,6,164,0.9207317073170732,0.042682926829268296,0.036585365853658534
PVP01_1434300,0,0,0,0,NaN,NaN,NaN
PVP01_1434600,19,4,5,28,0.6785714285714286,0.14285714285714285,0.17857142857142858
PVP01_1434700,1745,104,219,2068,0.8438104448742747,0.05029013539651837,0.10589941972920697
PVP01_1434900,573,30,28,631,0.9080824088748018,0.04754358161648178,0.044374009508716325
PVP01_1435100,1206,267,41,1514,0.7965653896961691,0.1763540290620872,0.027080581241743725
PVP01_1435200,284,26,10,320,0.8875,0.08125,0.03125
PVP01_1435300,7,0,2,9,0.7777777777777778,0,0.2222222222222222
PVP01_1435500,90,2,4,96,0.9375,0.020833333333333332,0.041666666666666664
PVP01_1435700,1420,1274,106,2800,0.5071428571428571,0.455,0.03785714285714286
PVP01_1435800,1022,38,23,1083,0.9436749769159741,0.03508771929824561,0.02123730378578024
PVP01_1436000,447,1344,78,1869,0.2391653290529695,0.7191011235955056,0.04173354735152488
PVP01_1436100,1027,81,22,1130,0.9088495575221239,0.07168141592920355,0.019469026548672566
PVP01_1436200,303,20,1044,1367,0.22165325530358448,0.014630577907827359,0.7637161667885881
PVP01_1436300,520,312,162,994,0.5231388329979879,0.31388329979879276,0.16297786720321933
PVP01_1436400,13,7,2,22,0.5909090909090909,0.3181818181818182,0.09090909090909091
PVP01_1436600,849,603,58,1510,0.562251655629139,0.39933774834437086,0.038410596026490065
PVP01_1436700,38,3,2,43,0.8837209302325582,0.06976744186046512,0.046511627906976744
PVP01_1436800,7,11,121,139,0.050359712230215826,0.07913669064748201,0.8705035971223022
PVP01_1436900,260,5,16,281,0.9252669039145908,0.017793594306049824,0.05693950177935943
PVP01_1437100,241,199,30,470,0.5127659574468085,0.42340425531914894,0.06382978723404255
PVP01_1437200,152,11,53,216,0.7037037037037037,0.05092592592592592,0.24537037037037038
PVP01_1437300,832,418,73,1323,0.6288737717309146,0.31594860166288735,0.05517762660619804
PVP01_1437400,837,104,52,993,0.8429003021148036,0.10473313192346426,0.05236656596173213
PVP01_1437600,15,1,0,16,0.9375,0.0625,0
PVP01_1437700,457,111,21,589,0.7758913412563667,0.18845500848896435,0.035653650254668934
PVP01_1437900,4381,295,447,5123,0.8551629904352919,0.057583447198906894,0.08725356236580128
PVP01_1438000,1307,135,656,2098,0.622974261201144,0.06434699714013346,0.3126787416587226
PVP01_1438100,0,0,0,0,NaN,NaN,NaN
PVP01_1438200,0,0,5,5,0,0,1
PVP01_1438300,164,22,3,189,0.8677248677248677,0.1164021164021164,0.015873015873015872
PVP01_1438400,32,3,2,37,0.8648648648648649,0.08108108108108109,0.05405405405405406
PVP01_1438500,2866,560,708,4134,0.6932752781809386,0.1354620222544751,0.17126269956458637
PVP01_1438700,904,26,116,1046,0.864244741873805,0.0248565965583174,0.11089866156787763
PVP01_1438800,871,166,663,1700,0.5123529411764706,0.0976470588235294,0.39
PVP01_1438900,583,168,27,778,0.7493573264781491,0.2159383033419023,0.03470437017994859
PVP01_1439000,707,32,29,768,0.9205729166666666,0.041666666666666664,0.037760416666666664
PVP01_1439100,28,11,35,74,0.3783783783783784,0.14864864864864866,0.47297297297297297
PVP01_1439200,345,35,65,445,0.7752808988764045,0.07865168539325842,0.14606741573033707
PVP01_1439300,566,35,152,753,0.751660026560425,0.04648074369189907,0.20185922974767595
PVP01_1439400,36,5,6,47,0.7659574468085106,0.10638297872340426,0.1276595744680851
PVP01_1439500,686,142,42,870,0.7885057471264367,0.1632183908045977,0.04827586206896552
PVP01_1439600,113,11,1385,1509,0.07488402915838303,0.00728959575878065,0.9178263750828363
PVP01_1439700,10,1,4,15,0.6666666666666666,0.06666666666666667,0.26666666666666666
PVP01_1439800,532,50,20,602,0.8837209302325582,0.08305647840531562,0.03322259136212625
PVP01_1439900,755,25,31,811,0.9309494451294698,0.030826140567200986,0.03822441430332922
PVP01_1440000,971,131,58,1160,0.8370689655172414,0.11293103448275862,0.05
PVP01_1440100,4717,194,136,5047,0.9346146225480484,0.03843867644145037,0.026946701010501287
PVP01_1440200,415,1000,543,1958,0.21195097037793667,0.5107252298263534,0.2773237997957099
PVP01_1440400,277,20,15,312,0.8878205128205128,0.0641025641025641,0.04807692307692308
PVP01_1440700,128,49,66,243,0.5267489711934157,0.20164609053497942,0.2716049382716049
PVP01_1440900,23,4,302,329,0.06990881458966565,0.0121580547112462,0.9179331306990881
PVP01_1441000,145,36,86,267,0.5430711610486891,0.1348314606741573,0.32209737827715357
PVP01_1441100,979,335,902,2216,0.4417870036101083,0.15117328519855597,0.40703971119133575
PVP01_1441200,49,4,23,76,0.6447368421052632,0.05263157894736842,0.3026315789473684
PVP01_1441300,3935,53,606,4594,0.8565520243796256,0.011536787113626469,0.13191118850674793
PVP01_1441400,2110,634,259,3003,0.7026307026307026,0.21112221112221113,0.08624708624708624
PVP01_1441500,2782,117,476,3375,0.8242962962962963,0.034666666666666665,0.14103703703703704
PVP01_1441600,3440,495,953,4888,0.7037643207855974,0.10126841243862521,0.19496726677577741
PVP01_1441800,1258,55,94,1407,0.8941009239516702,0.03909026297085998,0.06680881307746979
PVP01_1441900,560,17,11,588,0.9523809523809523,0.02891156462585034,0.01870748299319728
PVP01_1442000,194,76,2,272,0.7132352941176471,0.27941176470588236,0.007352941176470588
PVP01_1442200,560,125,22,707,0.7920792079207921,0.1768033946251768,0.031117397454031116
PVP01_1442300,74,0,100,174,0.42528735632183906,0,0.5747126436781609
PVP01_1442400,461,15,337,813,0.5670356703567035,0.01845018450184502,0.4145141451414514
PVP01_1442500,8448,8080,1730,18258,0.46270128162997043,0.44254573337714975,0.09475298499287983
PVP01_1442600,570,479,104,1153,0.4943625325238508,0.41543798785776237,0.09019947961838681
PVP01_1442700,1369,35,187,1591,0.8604651162790697,0.02199874292897549,0.11753614079195475
PVP01_1443000,763,23,47,833,0.9159663865546218,0.027611044417767107,0.056422569027611044
PVP01_1443100,91,27,11,129,0.7054263565891473,0.20930232558139536,0.08527131782945736
PVP01_1443200,299,96,95,490,0.610204081632653,0.19591836734693877,0.19387755102040816
PVP01_1443300,1629,114,222,1965,0.8290076335877863,0.05801526717557252,0.11297709923664122
PVP01_1443500,330,434,24,788,0.41878172588832485,0.550761421319797,0.030456852791878174
PVP01_1443700,315,526,33,874,0.36041189931350115,0.6018306636155606,0.03775743707093822
PVP01_1443800,2298,464,330,3092,0.7432082794307892,0.1500646830530401,0.10672703751617077
PVP01_1443900,279,90,18,387,0.7209302325581395,0.23255813953488372,0.046511627906976744
PVP01_1444000,1363,83,35,1481,0.9203241053342336,0.056043214044564485,0.02363268062120189
PVP01_1444100,190,18,7,215,0.8837209302325582,0.08372093023255814,0.03255813953488372
PVP01_1444200,523,41,15,579,0.9032815198618307,0.07081174438687392,0.025906735751295335
PVP01_1444600,986,56,301,1343,0.7341772151898734,0.04169769173492182,0.22412509307520476
PVP01_1444700,234,73,779,1086,0.2154696132596685,0.06721915285451197,0.7173112338858195
PVP01_1444800,466,16,98,580,0.803448275862069,0.027586206896551724,0.16896551724137931
PVP01_1444900,641,658,51,1350,0.4748148148148148,0.4874074074074074,0.03777777777777778
PVP01_1445000,225,10,13,248,0.907258064516129,0.04032258064516129,0.05241935483870968
PVP01_1445100,759,667,30,1456,0.5212912087912088,0.4581043956043956,0.020604395604395604
PVP01_1445200,165,3,73,241,0.6846473029045643,0.012448132780082987,0.3029045643153527
PVP01_1445400,1497,49,1149,2695,0.5554730983302412,0.01818181818181818,0.42634508348794065
PVP01_1445900,46,50,78,174,0.26436781609195403,0.28735632183908044,0.4482758620689655
PVP01_1446000,1102,1849,322,3273,0.33669416437519095,0.564925145126795,0.09838069049801405
PVP01_1446200,42,7,1,50,0.84,0.14,0.02
PVP01_1446300,315,6,5,326,0.9662576687116564,0.018404907975460124,0.015337423312883436
PVP01_1446400,457,46,14,517,0.8839458413926499,0.08897485493230174,0.027079303675048357
PVP01_1446500,1359,24,28,1411,0.9631467044649185,0.01700921332388377,0.019844082211197732
PVP01_1446600,2850,686,97,3633,0.7844756399669695,0.18882466281310212,0.026699697219928435
PVP01_1446900,1962,148,68,2178,0.9008264462809917,0.06795224977043159,0.031221303948576674
PVP01_1447200,233,30,29,292,0.797945205479452,0.10273972602739725,0.09931506849315068
PVP01_1447100,1973,111,345,2429,0.8122684232194318,0.04569781803211198,0.14203375874845617
PVP01_1447500,122,5,1,128,0.953125,0.0390625,0.0078125
PVP01_1447800,300,16,3,319,0.9404388714733543,0.050156739811912224,0.009404388714733543
PVP01_1448000,308,7,1145,1460,0.21095890410958903,0.004794520547945206,0.7842465753424658
PVP01_1448100,390,15,15,420,0.9285714285714286,0.03571428571428571,0.03571428571428571
PVP01_1448200,1646,80,45,1771,0.9294184076792772,0.04517221908526256,0.025409373235460192
PVP01_1448300,12,0,17,29,0.41379310344827586,0,0.5862068965517241
PVP01_1448500,3,0,13,16,0.1875,0,0.8125
PVP01_1448600,238,24,8,270,0.8814814814814815,0.08888888888888889,0.02962962962962963
PVP01_1448700,293,239,16,548,0.5346715328467153,0.43613138686131386,0.029197080291970802
PVP01_1448900,210,57,16,283,0.7420494699646644,0.20141342756183744,0.05653710247349823
PVP01_1449000,1318,699,49,2066,0.6379477250726041,0.3383349467570184,0.02371732817037754
PVP01_1449100,91,172,40,303,0.30033003300330036,0.5676567656765676,0.132013201320132
PVP01_1449300,109,12,124,245,0.4448979591836735,0.04897959183673469,0.5061224489795918
PVP01_1449400,1547,104,1175,2826,0.5474168435951875,0.03680113234253362,0.4157820240622788
PVP01_1449500,6,0,0,6,1,0,0
PVP01_1449700,21,8,4,33,0.6363636363636364,0.24242424242424243,0.12121212121212122
PVP01_1449900,13,1,0,14,0.9285714285714286,0.07142857142857142,0
PVP01_1450100,370,102,493,965,0.38341968911917096,0.10569948186528498,0.510880829015544
PVP01_1450200,849,55,22,926,0.9168466522678186,0.05939524838012959,0.023758099352051837
PVP01_1450300,4135,464,109,4708,0.8782922684791844,0.09855564995751911,0.023152081563296515
PVP01_1450500,432,7,9,448,0.9642857142857143,0.015625,0.020089285714285716
PVP01_1450600,1295,431,303,2029,0.6382454411039921,0.21241991128634796,0.14933464760965992
PVP01_1450700,892,20,611,1523,0.5856861457649376,0.013131976362442548,0.40118187787261983
PVP01_1450800,178,6,18,202,0.8811881188118812,0.0297029702970297,0.0891089108910891
PVP01_1450900,426,13,14,453,0.9403973509933775,0.02869757174392936,0.03090507726269316
PVP01_1451000,37,5,4,46,0.8043478260869565,0.10869565217391304,0.08695652173913043
PVP01_1451200,539,36,15,590,0.9135593220338983,0.061016949152542375,0.025423728813559324
PVP01_1451300,1016,277,71,1364,0.7448680351906158,0.20307917888563048,0.05205278592375367
PVP01_1451500,2841,286,64,3191,0.8903165151989971,0.08962707615167659,0.02005640864932623
PVP01_1451600,294,88,17,399,0.7368421052631579,0.22055137844611528,0.042606516290726815
PVP01_1451800,279,5,63,347,0.8040345821325648,0.01440922190201729,0.18155619596541786
PVP01_1451900,2647,332,615,3594,0.736505286588759,0.09237618252643294,0.17111853088480802
PVP01_1452000,305,59,281,645,0.4728682170542636,0.09147286821705426,0.4356589147286822
PVP01_1452100,355,36,57,448,0.7924107142857143,0.08035714285714286,0.12723214285714285
PVP01_1452400,1399,34,22,1455,0.961512027491409,0.02336769759450172,0.015120274914089347
PVP01_1452500,4,0,4,8,0.5,0,0.5
PVP01_1452600,914,82,119,1115,0.8197309417040358,0.07354260089686099,0.10672645739910314
PVP01_1452800,109,11,7,127,0.8582677165354331,0.08661417322834646,0.05511811023622047
PVP01_1452900,243,87,19,349,0.6962750716332379,0.2492836676217765,0.054441260744985676
PVP01_1453000,3543,163,620,4326,0.819001386962552,0.037679149329634766,0.14331946370781323
PVP01_1453100,14,1,4,19,0.7368421052631579,0.05263157894736842,0.21052631578947367
PVP01_1453200,294,66,470,830,0.3542168674698795,0.07951807228915662,0.5662650602409639
PVP01_1453400,2624,676,176,3476,0.7548906789413119,0.19447640966628307,0.05063291139240506
PVP01_1453500,135,19,6,160,0.84375,0.11875,0.0375
PVP01_1453600,211,79,6,296,0.7128378378378378,0.2668918918918919,0.02027027027027027
PVP01_1453700,2543,46,95,2684,0.9474664679582713,0.01713859910581222,0.03539493293591654
PVP01_1453800,4574,105,289,4968,0.9206924315619968,0.021135265700483092,0.05817230273752013
PVP01_1453900,128,7,19,154,0.8311688311688312,0.045454545454545456,0.12337662337662338
PVP01_1454000,558,79,57,694,0.8040345821325648,0.1138328530259366,0.08213256484149856
PVP01_1454200,130,32,6,168,0.7738095238095238,0.19047619047619047,0.03571428571428571
PVP01_1454300,124,17,29,170,0.7294117647058823,0.1,0.17058823529411765
PVP01_1454400,162,6,14,182,0.8901098901098901,0.03296703296703297,0.07692307692307693
PVP01_1454500,371,25,21,417,0.8896882494004796,0.05995203836930456,0.050359712230215826
PVP01_1454600,16,1,3,20,0.8,0.05,0.15
PVP01_1454700,25,3,2,30,0.8333333333333334,0.1,0.06666666666666667
PVP01_1454800,1119,86,29,1234,0.906807131280389,0.06969205834683954,0.023500810372771474
PVP01_1454900,362,23,31,416,0.8701923076923077,0.055288461538461536,0.07451923076923077
PVP01_1455000,560,6,307,873,0.6414662084765178,0.006872852233676976,0.3516609392898053
PVP01_1455100,1477,64,38,1579,0.935402153261558,0.04053198226725776,0.024065864471184292
PVP01_1455200,572,241,797,1610,0.3552795031055901,0.1496894409937888,0.49503105590062113
PVP01_1455300,703,509,175,1387,0.5068493150684932,0.36697909156452774,0.12617159336697908
PVP01_1455400,71,15,4,90,0.7888888888888889,0.16666666666666666,0.044444444444444446
PVP01_1455500,1188,73,166,1427,0.8325157673440785,0.051156271899089,0.11632796075683252
PVP01_1455700,869,919,75,1863,0.4664519592055824,0.4932903918411165,0.040257648953301126
PVP01_1455800,2627,1153,82,3862,0.6802175038839979,0.2985499741066805,0.021232522009321596
PVP01_1455900,30,12,3,45,0.6666666666666666,0.26666666666666666,0.06666666666666667
PVP01_1456200,737,135,19,891,0.8271604938271605,0.15151515151515152,0.02132435465768799
PVP01_1456300,474,69,1974,2517,0.18831942789034564,0.027413587604290822,0.7842669845053635
PVP01_1456400,886,269,285,1440,0.6152777777777778,0.18680555555555556,0.19791666666666666
PVP01_1456500,214,2,105,321,0.6666666666666666,0.006230529595015576,0.32710280373831774
PVP01_1456700,454,117,323,894,0.5078299776286354,0.13087248322147652,0.36129753914988816
PVP01_1456800,573,69,48,690,0.8304347826086956,0.1,0.06956521739130435
PVP01_1457000,19,2,202,223,0.08520179372197309,0.008968609865470852,0.905829596412556
PVP01_1457100,455,25,1088,1568,0.29017857142857145,0.01594387755102041,0.6938775510204082
PVP01_1457200,128,4,15,147,0.8707482993197279,0.027210884353741496,0.10204081632653061
PVP01_1457400,107,24,18,149,0.7181208053691275,0.1610738255033557,0.12080536912751678
PVP01_1458000,1131,147,129,1407,0.8038379530916845,0.1044776119402985,0.09168443496801706
PVP01_1458100,511,25,23,559,0.9141323792486583,0.044722719141323794,0.04114490161001789
PVP01_1458200,105,8,1,114,0.9210526315789473,0.07017543859649122,0.008771929824561403
PVP01_1458400,1051,105,18,1174,0.8952299829642248,0.08943781942078365,0.015332197614991482
PVP01_1458700,34,0,3,37,0.918918918918919,0,0.08108108108108109
PVP01_1458900,408,548,296,1252,0.3258785942492013,0.43769968051118213,0.2364217252396166
PVP01_1459100,128,25,107,260,0.49230769230769234,0.09615384615384616,0.4115384615384615
PVP01_1459200,48,4,11,63,0.7619047619047619,0.06349206349206349,0.1746031746031746
PVP01_1459400,74,12,1,87,0.8505747126436781,0.13793103448275862,0.011494252873563218
PVP01_1459600,1308,60,31,1399,0.9349535382416011,0.04288777698355969,0.02215868477483917
PVP01_1459700,878,109,17,1004,0.8745019920318725,0.10856573705179283,0.01693227091633466
PVP01_1459800,2698,1042,88,3828,0.7048066875653083,0.2722048066875653,0.022988505747126436
PVP01_1459900,173,26,3,202,0.8564356435643564,0.12871287128712872,0.01485148514851485
PVP01_1460100,1044,86,28,1158,0.9015544041450777,0.07426597582037997,0.024179620034542316
PVP01_1460200,738,192,444,1374,0.537117903930131,0.13973799126637554,0.3231441048034934
PVP01_1460300,620,101,111,832,0.7451923076923077,0.12139423076923077,0.13341346153846154
PVP01_1460400,2,0,0,2,1,0,0
PVP01_1460600,592,11,282,885,0.6689265536723163,0.012429378531073447,0.31864406779661014
PVP01_1460700,368,175,300,843,0.4365361803084223,0.20759193357058126,0.35587188612099646
PVP01_1460800,21,1,139,161,0.13043478260869565,0.006211180124223602,0.8633540372670807
PVP01_1461000,1122,29,540,1691,0.6635127143701951,0.01714961561206387,0.319337670017741
PVP01_1461100,415,116,17,548,0.7572992700729927,0.2116788321167883,0.03102189781021898
PVP01_1461200,780,845,39,1664,0.46875,0.5078125,0.0234375
PVP01_1461300,625,152,20,797,0.7841907151819323,0.19071518193224593,0.025094102885821833
PVP01_1461700,76,5,14,95,0.8,0.05263157894736842,0.14736842105263157
PVP01_1461800,1039,44,1020,2103,0.4940561103185925,0.020922491678554447,0.48502139800285304
PVP01_1461900,1734,504,76,2314,0.749351771823682,0.21780466724286948,0.032843560933448576
PVP01_1462000,1841,200,100,2141,0.8598785614198973,0.09341429238673517,0.046707146193367584
PVP01_1462100,445,3,82,530,0.839622641509434,0.005660377358490566,0.15471698113207547
PVP01_1462200,893,20,241,1154,0.7738301559792028,0.01733102253032929,0.20883882149046792
PVP01_1462400,64,2,2,68,0.9411764705882353,0.029411764705882353,0.029411764705882353
PVP01_1462600,2084,118,146,2348,0.8875638841567292,0.05025553662691652,0.062180579216354344
PVP01_1462700,207,22,17,246,0.8414634146341463,0.08943089430894309,0.06910569105691057
PVP01_1462800,368,45,326,739,0.4979702300405954,0.06089309878213803,0.44113667117726657
PVP01_1462900,24,20,1,45,0.5333333333333333,0.4444444444444444,0.022222222222222223
PVP01_1463000,89,1,8,98,0.9081632653061225,0.01020408163265306,0.08163265306122448
PVP01_1463100,15,0,0,15,1,0,0
PVP01_1463400,2183,371,2052,4606,0.4739470256187581,0.08054711246200608,0.4455058619192358
PVP01_1463500,30,77,1439,1546,0.019404915912031046,0.04980595084087969,0.9307891332470892
PVP01_1463700,1982,267,133,2382,0.8320738874895046,0.11209068010075567,0.05583543240973971
PVP01_1463800,617,93,22,732,0.842896174863388,0.12704918032786885,0.030054644808743168
PVP01_1463900,106,4,6,116,0.9137931034482759,0.034482758620689655,0.05172413793103448
PVP01_1464000,43,2,11,56,0.7678571428571429,0.03571428571428571,0.19642857142857142
PVP01_1464200,175,13,10,198,0.8838383838383839,0.06565656565656566,0.050505050505050504
PVP01_1464300,1207,364,177,1748,0.6905034324942791,0.20823798627002288,0.10125858123569793
PVP01_1464400,103,18,13,134,0.7686567164179104,0.13432835820895522,0.09701492537313433
PVP01_1464500,3540,391,103,4034,0.8775409023301933,0.0969261279127417,0.025532969757064948
PVP01_1464600,400,1,1066,1467,0.27266530334015,6.816632583503749e-4,0.7266530334014997
PVP01_1464700,79,11,11,101,0.7821782178217822,0.10891089108910891,0.10891089108910891
PVP01_1465000,525,428,43,996,0.5271084337349398,0.42971887550200805,0.04317269076305221
PVP01_1465100,370,10,24,404,0.9158415841584159,0.024752475247524754,0.0594059405940594
PVP01_1465200,333,200,15,548,0.6076642335766423,0.36496350364963503,0.02737226277372263
PVP01_1465300,212,57,32,301,0.7043189368770764,0.1893687707641196,0.10631229235880399
PVP01_1465400,71,3,2,76,0.9342105263157895,0.039473684210526314,0.02631578947368421
PVP01_1465500,167,32,27,226,0.7389380530973452,0.1415929203539823,0.11946902654867257
PVP01_1465600,152,36,74,262,0.5801526717557252,0.13740458015267176,0.2824427480916031
PVP01_1465700,834,13,16,863,0.966396292004635,0.015063731170336037,0.01853997682502897
PVP01_1465900,483,43,12,538,0.8977695167286245,0.07992565055762081,0.022304832713754646
PVP01_1466000,1496,54,54,1604,0.9326683291770573,0.03366583541147132,0.03366583541147132
PVP01_1466100,251,42,6,299,0.8394648829431438,0.14046822742474915,0.020066889632107024
PVP01_1466200,1254,961,48,2263,0.554131683605833,0.4246575342465753,0.021210782147591693
PVP01_1466300,12,0,1,13,0.9230769230769231,0,0.07692307692307693
PVP01_1466400,702,166,39,907,0.7739801543550165,0.18302094818081588,0.04299889746416759
PVP01_1466500,18,0,3,21,0.8571428571428571,0,0.14285714285714285
PVP01_1466600,169,9,4,182,0.9285714285714286,0.04945054945054945,0.02197802197802198
PVP01_1466700,37,0,17,54,0.6851851851851852,0,0.3148148148148148
PVP01_1466900,4046,832,513,5391,0.7505101094416621,0.15433129289556669,0.09515859766277128
PVP01_1467100,974,880,49,1903,0.511823436678928,0.4624277456647399,0.025748817656332107
PVP01_1467200,804,42,30,876,0.9178082191780822,0.04794520547945205,0.03424657534246575
PVP01_1467300,314,48,239,601,0.5224625623960066,0.07986688851913477,0.39767054908485855
PVP01_1467400,366,8,29,403,0.9081885856079405,0.019851116625310174,0.07196029776674938
PVP01_1467500,338,101,249,688,0.49127906976744184,0.14680232558139536,0.36191860465116277
PVP01_1467600,88,16,13,117,0.7521367521367521,0.13675213675213677,0.1111111111111111
PVP01_1467700,1389,403,110,1902,0.7302839116719243,0.21188222923238695,0.05783385909568875
PVP01_1467800,212,10,10,232,0.9137931034482759,0.04310344827586207,0.04310344827586207
PVP01_1467900,2062,156,68,2286,0.9020122484689413,0.06824146981627296,0.02974628171478565
PVP01_1468000,1720,1384,92,3196,0.5381727158948686,0.4330413016270338,0.028785982478097622
PVP01_1468100,11,1,5,17,0.6470588235294118,0.058823529411764705,0.29411764705882354
PVP01_1468200,135,69,13,217,0.6221198156682027,0.31797235023041476,0.059907834101382486
PVP01_1468300,26,1,28,55,0.4727272727272727,0.01818181818181818,0.509090909090909
PVP01_1468400,350,11,21,382,0.9162303664921466,0.028795811518324606,0.0549738219895288
PVP01_1468500,218,99,14,331,0.6586102719033232,0.2990936555891239,0.04229607250755287
PVP01_1468600,1528,2529,1659,5716,0.26731980405878236,0.4424422673198041,0.29023792862141357
PVP01_1468800,1175,195,70,1440,0.8159722222222222,0.13541666666666666,0.04861111111111111
PVP01_1469200,409,8,852,1269,0.322301024428684,0.006304176516942475,0.6713947990543735
